Player,Pos,Age,Tm,G,GS,MP,FG,FGA,FG%,3P,3PA,3P%,2P,2PA,2P%,eFG%,FT,FTA,FT%,ORB,DRB,TRB,AST,STL,BLK,PF,TOV,PTS
Steven Adams,C,26,OKC,58,58,1564,262,443,0.591,1,3,0.333,261,440,0.593,0.593,108,183,0.59,196,347,543,141,50,65,86,111,633
Bam Adebayo,PF,22,MIA,65,65,2235,408,719,0.567,1,13,0.077,407,706,0.576,0.568,236,342,0.69,165,518,683,333,78,85,185,164,1053
LaMarcus Aldridge,C,34,SAS,53,53,1754,391,793,0.493,61,157,0.389,330,636,0.519,0.532,158,191,0.827,103,289,392,129,36,87,74,128,1001
Nickeil Alexander-Walker,SG,21,NOP,41,0,501,77,227,0.339,40,117,0.342,37,110,0.336,0.427,17,28,0.607,8,72,80,74,11,7,40,46,211
Grayson Allen,SG,24,MEM,30,0,498,79,176,0.449,33,91,0.363,46,85,0.541,0.543,30,35,0.857,5,61,66,43,6,1,23,36,221
Jarrett Allen,C,21,BRK,64,58,1647,267,413,0.646,0,5,0,267,408,0.654,0.646,147,237,0.62,195,410,605,85,37,85,72,144,681
Kadeem Allen,SG,27,NYK,10,0,117,19,44,0.432,5,16,0.313,14,28,0.5,0.489,7,11,0.636,2,7,9,21,5,2,8,7,50
Al-Farouq Aminu,PF,29,ORL,18,2,380,25,86,0.291,9,36,0.25,16,50,0.32,0.343,19,29,0.655,24,63,87,21,18,8,17,27,78
Justin Anderson,SF,26,BRK,3,0,17,1,6,0.167,0,3,0,1,3,0.333,0.167,1,2,0.5,0,2,2,0,0,1,0,2,3
Kyle Anderson,PF,26,MEM,59,20,1140,138,280,0.493,16,62,0.258,122,218,0.56,0.521,43,66,0.652,54,203,257,132,46,31,55,85,335
Ryan Anderson,PF,31,HOU,2,0,14,2,7,0.286,1,5,0.2,1,2,0.5,0.357,0,0,,0,7,7,2,1,0,1,1,5
Giannis Antetokounmpo,PF,25,MIL,57,57,1763,623,1139,0.547,83,271,0.306,540,868,0.622,0.583,361,570,0.633,130,653,783,329,59,58,209,173,1690
Kostas Antetokounmpo,PF,22,LAL,3,0,5,0,0,,0,0,,0,0,,,0,0,,0,1,1,1,0,0,0,0,0
Thanasis Antetokounmpo,SF,27,MIL,18,2,93,19,36,0.528,0,7,0,19,29,0.655,0.528,7,15,0.467,11,8,19,9,6,2,11,13,45
Carmelo Anthony,PF,35,POR,50,50,1623,289,679,0.426,72,194,0.371,217,485,0.447,0.479,113,134,0.843,61,252,313,79,40,23,87,142,763
OG Anunoby,SF,22,TOR,63,62,1897,267,527,0.507,82,215,0.381,185,312,0.593,0.584,59,86,0.686,74,267,341,99,88,42,75,155,675
Ryan Arcidiacono,PG,25,CHI,58,4,930,90,220,0.409,54,138,0.391,36,82,0.439,0.532,27,38,0.711,20,90,110,96,27,3,37,96,261
Trevor Ariza,SF,34,TOT,53,21,1493,142,324,0.438,77,207,0.372,65,117,0.556,0.557,62,74,0.838,34,212,246,91,69,15,56,111,423
Trevor Ariza,SF,34,SAC,32,0,791,64,165,0.388,43,122,0.352,21,43,0.488,0.518,21,27,0.778,21,125,146,50,35,7,28,63,192
Trevor Ariza,SF,34,POR,21,21,702,78,159,0.491,34,85,0.4,44,74,0.595,0.597,41,47,0.872,13,87,100,41,34,8,28,48,231
D.J. Augustin,PG,32,ORL,49,6,1215,156,397,0.393,60,174,0.345,96,223,0.43,0.469,139,157,0.885,18,91,109,223,30,1,69,53,511
Deandre Ayton,C,21,PHO,30,25,996,255,465,0.548,0,3,0,255,462,0.552,0.548,60,78,0.769,123,237,360,57,22,51,71,97,570
Dwayne Bacon,SG,24,CHO,39,11,687,85,244,0.348,19,67,0.284,66,177,0.373,0.387,35,53,0.66,15,85,100,52,23,2,37,52,224
Marvin Bagley III,PF,20,SAC,13,6,334,78,167,0.467,4,22,0.182,74,145,0.51,0.479,25,31,0.806,29,68,97,10,6,12,18,43,185
Lonzo Ball,PG,22,NOP,56,47,1817,259,628,0.412,139,363,0.383,120,265,0.453,0.523,38,67,0.567,63,285,348,392,80,30,172,110,695
Mo Bamba,C,21,ORL,60,0,868,132,282,0.468,37,104,0.356,95,178,0.534,0.534,31,46,0.674,98,201,299,42,22,85,42,115,332
J.J. Barea,PG,35,DAL,26,4,391,74,179,0.413,29,76,0.382,45,103,0.437,0.494,17,18,0.944,10,38,48,99,4,2,35,25,194
Harrison Barnes,PF,27,SAC,64,64,2231,326,711,0.459,93,243,0.383,233,468,0.498,0.524,196,244,0.803,61,245,306,152,38,10,80,82,941
RJ Barrett,SG,19,NYK,56,55,1704,292,727,0.402,63,197,0.32,229,530,0.432,0.445,156,254,0.614,50,229,279,143,55,17,124,122,803
Will Barton,SF,29,DEN,58,58,1916,332,738,0.45,108,288,0.375,224,450,0.498,0.523,102,133,0.767,76,289,365,212,61,29,88,121,874
Keita Bates-Diop,SF,24,TOT,39,0,665,89,208,0.428,31,94,0.33,58,114,0.509,0.502,49,69,0.71,21,91,112,30,17,21,14,38,258
Keita Bates-Diop,SF,24,MIN,37,0,646,87,206,0.422,31,94,0.33,56,112,0.5,0.498,46,65,0.708,21,89,110,30,17,20,14,36,251
Keita Bates-Diop,SF,24,DEN,2,0,19,2,2,1,0,0,,2,2,1,1,3,4,0.75,0,2,2,0,0,1,0,2,7
Nicolas Batum,SF,31,CHO,22,3,505,28,81,0.346,14,49,0.286,14,32,0.438,0.432,9,10,0.9,25,75,100,66,17,8,22,41,79
Aron Baynes,C,33,PHO,42,28,934,183,381,0.48,59,168,0.351,124,213,0.582,0.558,56,75,0.747,71,166,237,67,10,23,50,141,481
Kent Bazemore,SF-SG,30,TOT,64,21,1604,185,495,0.374,78,228,0.342,107,267,0.401,0.453,109,142,0.768,24,253,277,85,70,39,85,182,557
Kent Bazemore,SF,30,POR,43,21,1111,113,326,0.347,56,171,0.327,57,155,0.368,0.433,58,72,0.806,13,159,172,61,45,31,60,121,340
Kent Bazemore,SG,30,SAC,21,0,493,72,169,0.426,22,57,0.386,50,112,0.446,0.491,51,70,0.729,11,94,105,24,25,8,25,61,217
Darius Bazley,PF,19,OKC,53,8,909,88,230,0.383,30,100,0.3,58,130,0.446,0.448,32,47,0.681,21,175,196,29,20,35,40,45,238
Bradley Beal,SG,26,WAS,57,57,2053,593,1303,0.455,170,481,0.353,423,822,0.515,0.52,385,457,0.842,52,190,242,347,71,23,194,126,1741
Malik Beasley,SG,23,TOT,55,14,1209,227,534,0.425,107,276,0.388,120,258,0.465,0.525,54,66,0.818,18,130,148,75,40,8,57,77,615
Malik Beasley,SG,23,DEN,41,0,746,117,301,0.389,58,161,0.36,59,140,0.421,0.485,33,38,0.868,9,68,77,48,31,6,36,50,325
Malik Beasley,SG,23,MIN,14,14,463,110,233,0.472,49,115,0.426,61,118,0.517,0.577,21,28,0.75,9,62,71,27,9,2,21,27,290
Marco Belinelli,SG,33,SAS,52,0,779,106,271,0.391,57,155,0.368,49,116,0.422,0.496,32,41,0.78,4,86,90,64,10,1,16,41,301
Jordan Bell,C-PF,25,TOT,29,0,256,35,67,0.522,4,12,0.333,31,55,0.564,0.552,19,31,0.613,30,51,81,16,3,10,21,19,93
Jordan Bell,C,25,MIN,27,0,235,32,60,0.533,2,9,0.222,30,51,0.588,0.55,17,29,0.586,28,50,78,14,2,10,18,17,83
Jordan Bell,PF,25,MEM,2,0,21,3,7,0.429,2,3,0.667,1,4,0.25,0.571,2,2,1,2,1,3,2,1,0,3,2,10
DeAndre' Bembry,SG,25,ATL,43,4,915,104,228,0.456,15,65,0.231,89,163,0.546,0.489,26,48,0.542,34,118,152,81,55,19,60,84,249
Dragan Bender,SF,22,TOT,16,3,286,41,92,0.446,15,43,0.349,26,49,0.531,0.527,10,14,0.714,16,57,73,28,4,9,21,42,107
Dragan Bender,SF,22,MIL,7,0,91,10,21,0.476,4,9,0.444,6,12,0.5,0.571,2,3,0.667,0,20,20,9,0,5,5,16,26
Dragan Bender,SF,22,GSW,9,3,195,31,71,0.437,11,34,0.324,20,37,0.541,0.514,8,11,0.727,16,37,53,19,4,4,16,26,81
Dāvis Bertāns,PF,27,WAS,54,4,1583,265,610,0.434,200,472,0.424,65,138,0.471,0.598,104,122,0.852,35,210,245,92,37,33,59,139,834
Patrick Beverley,PG,31,LAC,48,48,1299,139,325,0.428,75,198,0.379,64,127,0.504,0.543,27,41,0.659,56,203,259,179,53,25,64,150,380
Khem Birch,C,27,ORL,40,24,777,56,115,0.487,0,1,0,56,114,0.491,0.487,41,67,0.612,70,110,180,35,16,21,23,73,153
Goga Bitadze,C,20,IND,49,2,410,61,129,0.473,6,36,0.167,55,93,0.591,0.496,24,33,0.727,22,74,96,21,6,32,25,57,152
Bismack Biyombo,C,27,CHO,53,29,1029,151,278,0.543,0,0,,151,278,0.543,0.543,91,151,0.603,120,188,308,50,10,49,48,116,393
Nemanja Bjelica,PF,31,SAC,64,61,1821,287,604,0.475,125,295,0.424,162,309,0.524,0.579,60,73,0.822,107,305,412,179,54,33,92,193,759
Eric Bledsoe,PG,30,MIL,56,56,1524,319,662,0.482,70,201,0.348,249,461,0.54,0.535,157,193,0.813,41,218,259,302,53,25,140,120,865
Bogdan Bogdanović,SG,27,SAC,53,20,1510,277,639,0.433,137,380,0.361,140,259,0.541,0.541,76,105,0.724,17,154,171,169,54,14,89,115,767
Bojan Bogdanović,SF,30,UTA,63,63,2083,418,935,0.447,189,457,0.414,229,478,0.479,0.548,250,277,0.903,39,220,259,131,34,7,159,110,1275
Jonah Bolden,PF,24,TOT,7,0,47,4,11,0.364,0,4,0,4,7,0.571,0.364,2,4,0.5,3,6,9,0,3,2,2,10,10
Jonah Bolden,PF,24,PHI,4,0,14,2,3,0.667,0,1,0,2,2,1,0.667,0,2,0,0,1,1,0,1,0,2,4,4
Jonah Bolden,PF,24,PHO,3,0,33,2,8,0.25,0,3,0,2,5,0.4,0.25,2,2,1,3,5,8,0,2,2,0,6,6
Marques Bolden,C,21,CLE,1,0,3,0,0,,0,0,,0,0,,,0,0,,0,2,2,0,1,0,0,1,0
Jordan Bone,PG,22,DET,10,0,53,5,20,0.25,2,10,0.2,3,10,0.3,0.3,0,0,,0,4,4,8,1,0,2,6,12
Isaac Bonga,SF,20,WAS,58,41,1025,96,184,0.522,22,55,0.4,74,129,0.574,0.582,52,64,0.813,61,122,183,61,37,21,41,136,266
Devin Booker,SG,23,PHO,62,62,2241,544,1118,0.487,126,350,0.36,418,768,0.544,0.543,405,442,0.916,27,231,258,408,45,16,244,188,1619
Chris Boucher,PF,27,TOR,55,0,724,119,260,0.458,28,99,0.283,91,161,0.565,0.512,82,103,0.796,94,148,242,23,20,53,23,104,348
Brian Bowen,SG,21,IND,5,1,29,2,9,0.222,0,2,0,2,7,0.286,0.222,0,0,,1,6,7,0,0,1,1,2,4
Ky Bowman,PG,22,GSW,45,12,1015,134,321,0.417,33,107,0.308,101,214,0.472,0.469,34,41,0.829,24,97,121,131,44,10,70,102,335
Avery Bradley,SG,29,LAL,49,44,1186,170,383,0.444,63,173,0.364,107,210,0.51,0.526,20,24,0.833,18,97,115,63,43,5,47,110,423
Tony Bradley,C,22,UTA,50,2,535,103,155,0.665,1,1,1,102,154,0.662,0.668,26,40,0.65,90,126,216,17,12,25,23,98,233
Jarrell Brantley,PF,23,UTA,5,0,13,0,0,,0,0,,0,0,,,0,0,,0,5,5,1,0,2,2,2,0
Ignas Brazdeikis,SF,21,NYK,9,0,53,6,22,0.273,1,9,0.111,5,13,0.385,0.295,4,5,0.8,2,3,5,4,0,1,2,3,17
Mikal Bridges,SF,23,PHO,65,24,1772,210,407,0.516,56,159,0.352,154,248,0.621,0.585,89,105,0.848,59,200,259,115,93,39,65,142,565
Miles Bridges,SF,21,CHO,65,64,1995,319,753,0.424,99,300,0.33,220,453,0.486,0.489,106,131,0.809,88,274,362,114,40,48,95,132,843
Oshae Brissett,SF,21,TOR,19,0,135,13,36,0.361,3,15,0.2,10,21,0.476,0.403,8,10,0.8,9,17,26,7,4,1,7,18,37
Ryan Broekhoff,SG,29,DAL,17,1,180,22,59,0.373,20,51,0.392,2,8,0.25,0.542,7,8,0.875,5,38,43,11,5,4,6,15,71
Malcolm Brogdon,PG,27,IND,48,48,1472,289,659,0.439,61,195,0.313,228,464,0.491,0.485,145,162,0.895,40,186,226,343,33,8,115,88,784
Dillon Brooks,SG,24,MEM,65,65,1851,372,925,0.402,132,358,0.369,240,567,0.423,0.474,144,178,0.809,61,152,213,128,57,25,108,246,1020
Bruce Brown,SG,23,DET,58,43,1634,198,447,0.443,33,96,0.344,165,351,0.47,0.48,88,119,0.739,61,213,274,230,63,29,100,162,517
Charlie Brown,SG,22,ATL,10,0,40,6,19,0.316,3,9,0.333,3,10,0.3,0.395,5,5,1,2,2,4,2,2,2,3,3,20
Jaylen Brown,SF,23,BOS,50,50,1702,378,772,0.49,107,281,0.381,271,491,0.552,0.559,159,216,0.736,54,264,318,109,56,16,116,151,1022
Moses Brown,C,20,POR,9,0,33,4,10,0.4,0,0,,4,10,0.4,0.4,3,8,0.375,3,11,14,1,1,1,3,7,11
Sterling Brown,SF,24,MIL,45,1,665,80,218,0.367,36,114,0.316,44,104,0.423,0.45,27,35,0.771,28,137,165,46,22,7,36,45,223
Troy Brown Jr.,SG,20,WAS,61,14,1519,229,506,0.453,50,145,0.345,179,361,0.496,0.502,86,114,0.754,64,261,325,142,76,6,65,110,594
Jalen Brunson,PG,23,DAL,57,16,1022,181,388,0.466,43,120,0.358,138,268,0.515,0.522,61,75,0.813,22,112,134,188,22,4,66,74,466
Thomas Bryant,C,22,WAS,38,28,901,184,307,0.599,22,54,0.407,162,253,0.64,0.635,70,95,0.737,75,185,260,71,14,33,48,85,460
Reggie Bullock,SG,28,NYK,29,19,684,90,224,0.402,37,111,0.333,53,113,0.469,0.484,17,21,0.81,13,55,68,42,25,3,19,56,234
Trey Burke,PG,27,PHI,25,0,329,59,127,0.465,16,38,0.421,43,89,0.483,0.528,13,18,0.722,15,20,35,53,7,1,12,21,147
Alec Burks,SG,28,TOT,59,18,1612,283,701,0.404,100,273,0.366,183,428,0.428,0.475,225,251,0.896,43,219,262,171,58,17,85,120,891
Alec Burks,SG,28,GSW,48,18,1390,244,601,0.406,84,224,0.375,160,377,0.424,0.476,201,224,0.897,37,189,226,151,50,17,76,107,773
Alec Burks,SG,28,PHI,11,0,222,39,100,0.39,16,49,0.327,23,51,0.451,0.47,24,27,0.889,6,30,36,20,8,0,9,13,118
Deonte Burton,SG,26,OKC,34,0,284,39,105,0.371,10,46,0.217,29,59,0.492,0.419,6,12,0.5,6,42,48,11,5,10,14,28,94
Jimmy Butler,SF,30,MIA,54,54,1851,328,722,0.454,29,117,0.248,299,605,0.494,0.474,408,490,0.833,98,261,359,331,92,29,118,74,1093
Bruno Caboclo,SF,24,TOT,27,0,220,32,77,0.416,4,28,0.143,28,49,0.571,0.442,4,5,0.8,22,31,53,12,12,16,9,25,72
Bruno Caboclo,SF,24,MEM,22,0,192,28,69,0.406,4,25,0.16,24,44,0.545,0.435,2,3,0.667,17,27,44,10,10,12,7,23,62
Bruno Caboclo,SF,24,HOU,5,0,28,4,8,0.5,0,3,0,4,5,0.8,0.5,2,2,1,5,4,9,2,2,4,2,2,10
Kentavious Caldwell-Pope,SG,26,LAL,63,20,1603,220,466,0.472,87,221,0.394,133,245,0.543,0.565,74,95,0.779,37,95,132,105,53,13,55,117,601
Vlatko Čančar,SF,22,DEN,14,0,45,6,15,0.4,1,6,0.167,5,9,0.556,0.433,4,4,1,5,5,10,3,1,1,3,7,17
Clint Capela,C,25,HOU,39,39,1279,244,388,0.629,0,0,,244,388,0.629,0.629,55,104,0.529,168,369,537,48,33,72,63,102,543
DeMarre Carroll,SF,33,TOT,21,0,231,21,54,0.389,7,27,0.259,14,27,0.519,0.454,24,36,0.667,11,36,47,18,4,4,16,28,73
DeMarre Carroll,SF,33,SAS,15,0,135,9,29,0.31,3,13,0.231,6,16,0.375,0.362,12,20,0.6,7,24,31,11,2,2,10,20,33
DeMarre Carroll,SF,33,HOU,6,0,96,12,25,0.48,4,14,0.286,8,11,0.727,0.56,12,16,0.75,4,12,16,7,2,2,6,8,40
Jevon Carter,PG,24,PHO,50,2,754,82,205,0.4,46,117,0.393,36,88,0.409,0.512,21,25,0.84,25,73,98,65,38,13,31,76,231
Vince Carter,SF,43,ATL,60,0,876,107,304,0.352,61,202,0.302,46,102,0.451,0.452,23,29,0.793,18,106,124,48,23,25,33,90,298
Wendell Carter Jr.,C,20,CHI,43,43,1256,183,343,0.534,6,29,0.207,177,314,0.564,0.542,112,152,0.737,139,266,405,51,33,36,72,162,484
Michael Carter-Williams,SG,28,ORL,42,0,773,105,242,0.434,20,68,0.294,85,174,0.489,0.475,72,87,0.828,44,96,140,102,45,20,48,78,302
Alex Caruso,PG,25,LAL,58,1,1032,110,260,0.423,38,107,0.355,72,153,0.471,0.496,58,76,0.763,14,98,112,102,60,17,46,85,316
Willie Cauley-Stein,C,26,TOT,54,39,1097,175,302,0.579,0,1,0,175,301,0.581,0.579,40,66,0.606,84,231,315,70,49,61,40,121,390
Willie Cauley-Stein,C,26,GSW,41,37,940,144,257,0.56,0,0,,144,257,0.56,0.56,35,57,0.614,71,184,255,60,45,50,35,102,323
Willie Cauley-Stein,C,26,DAL,13,2,157,31,45,0.689,0,1,0,31,44,0.705,0.689,5,9,0.556,13,47,60,10,4,11,5,19,67
Tyson Chandler,C,37,HOU,26,5,219,14,18,0.778,0,0,,14,18,0.778,0.778,6,13,0.462,25,41,66,6,6,8,8,32,34
Wilson Chandler,SF,32,BRK,35,3,734,74,183,0.404,37,121,0.306,37,62,0.597,0.505,20,23,0.87,11,134,145,39,16,12,34,79,205
Joe Chealey,PG,24,CHO,4,0,33,0,7,0,0,4,0,0,3,0,0,2,2,1,0,0,0,1,4,0,2,2,2
Zylan Cheatham,SF,24,NOP,3,0,31,2,5,0.4,0,1,0,2,4,0.5,0.4,0,0,,1,5,6,2,0,1,3,5,4
Chris Chiozza,PG,24,TOT,21,0,249,32,79,0.405,18,41,0.439,14,38,0.368,0.519,2,2,1,6,29,35,48,15,2,17,23,84
Chris Chiozza,PG,24,WAS,10,0,123,10,34,0.294,7,16,0.438,3,18,0.167,0.397,0,0,,0,15,15,28,10,2,9,12,27
Chris Chiozza,PG,24,BRK,11,0,126,22,45,0.489,11,25,0.44,11,20,0.55,0.611,2,2,1,6,14,20,20,5,0,8,11,57
Marquese Chriss,PF,22,GSW,59,21,1196,210,385,0.545,8,39,0.205,202,346,0.584,0.556,120,156,0.769,114,251,365,114,39,62,78,122,548
Gary Clark,PF,25,TOT,35,1,425,38,101,0.376,28,86,0.326,10,15,0.667,0.515,8,9,0.889,27,58,85,15,5,14,5,31,112
Gary Clark,PF,25,HOU,18,0,212,23,59,0.39,18,51,0.353,5,8,0.625,0.542,6,7,0.857,11,29,40,12,2,7,2,21,70
Gary Clark,PF,25,ORL,17,1,213,15,42,0.357,10,35,0.286,5,7,0.714,0.476,2,2,1,16,29,45,3,3,7,3,10,42
Brandon Clarke,PF,23,MEM,50,3,1086,254,408,0.623,21,52,0.404,233,356,0.654,0.648,73,93,0.785,78,214,292,72,26,42,46,82,602
Jordan Clarkson,SG,27,TOT,63,0,1527,350,753,0.465,130,353,0.368,220,400,0.55,0.551,122,145,0.841,47,120,167,124,43,15,82,92,952
Jordan Clarkson,SG,27,CLE,29,0,666,144,326,0.442,59,159,0.371,85,167,0.509,0.532,76,86,0.884,21,48,69,70,17,8,39,33,423
Jordan Clarkson,SG,27,UTA,34,0,861,206,427,0.482,71,194,0.366,135,233,0.579,0.566,46,59,0.78,26,72,98,54,26,7,43,59,529
Nicolas Claxton,PF,20,BRK,15,0,187,27,48,0.563,1,7,0.143,26,41,0.634,0.573,11,21,0.524,19,25,44,16,1,8,9,14,66
Chris Clemons,SG,22,HOU,29,0,251,51,126,0.405,33,94,0.351,18,32,0.563,0.536,6,7,0.857,3,20,23,22,6,5,17,20,141
Antonius Cleveland,SG,25,DAL,6,0,22,2,6,0.333,0,1,0,2,5,0.4,0.333,1,2,0.5,0,3,3,0,1,1,1,2,5
Amir Coffey,SG,22,LAC,13,0,98,13,33,0.394,1,7,0.143,12,26,0.462,0.409,1,3,0.333,4,10,14,9,1,1,3,12,28
John Collins,PF,22,ATL,41,41,1363,353,605,0.583,59,147,0.401,294,458,0.642,0.632,120,150,0.8,116,300,416,60,31,66,75,138,885
Zach Collins,PF,22,POR,3,3,86,9,19,0.474,3,7,0.429,6,12,0.5,0.553,6,6,1,4,8,12,6,0,2,6,11,27
Mike Conley,PG,32,UTA,41,35,1171,197,486,0.405,80,213,0.376,117,273,0.429,0.488,93,117,0.795,27,106,133,178,31,4,76,92,567
Pat Connaughton,SG,27,MIL,61,1,1119,119,261,0.456,44,137,0.321,75,124,0.605,0.54,27,36,0.75,56,203,259,95,20,30,47,60,309
Quinn Cook,PG,26,LAL,38,0,409,76,173,0.439,25,66,0.379,51,107,0.477,0.512,6,9,0.667,7,33,40,40,11,1,25,23,183
Tyler Cook,PF,22,CLE,11,0,35,7,10,0.7,0,0,,7,10,0.7,0.7,5,6,0.833,4,6,10,1,1,0,1,4,19
Robert Covington,PF,29,TOT,62,60,1867,280,648,0.432,148,424,0.349,132,224,0.589,0.546,86,108,0.796,54,343,397,74,95,80,93,196,794
Robert Covington,PF,29,MIN,48,47,1411,216,496,0.435,108,312,0.346,108,184,0.587,0.544,75,94,0.798,36,251,287,56,80,45,73,148,615
Robert Covington,PF,29,HOU,14,13,456,64,152,0.421,40,112,0.357,24,40,0.6,0.553,11,14,0.786,18,92,110,18,15,35,20,48,179
Allen Crabbe,SG,27,TOT,37,1,653,63,177,0.356,36,119,0.303,27,58,0.466,0.458,10,14,0.714,11,66,77,33,15,4,17,47,172
Allen Crabbe,SG,27,ATL,28,1,522,52,143,0.364,30,93,0.323,22,50,0.44,0.469,9,12,0.75,10,55,65,28,15,4,12,36,143
Allen Crabbe,SG,27,MIN,9,0,131,11,34,0.324,6,26,0.231,5,8,0.625,0.412,1,2,0.5,1,11,12,5,0,0,5,11,29
Torrey Craig,SF,29,DEN,50,19,869,96,208,0.462,36,109,0.33,60,99,0.606,0.548,20,31,0.645,48,108,156,34,18,32,22,112,248
Jae Crowder,SF,29,TOT,58,46,1695,197,513,0.384,113,355,0.318,84,158,0.532,0.494,95,121,0.785,48,305,353,151,67,21,62,126,602
Jae Crowder,SF,29,MEM,45,45,1322,147,399,0.368,78,266,0.293,69,133,0.519,0.466,75,95,0.789,40,237,277,125,47,14,54,85,447
Jae Crowder,SF,29,MIA,13,1,373,50,114,0.439,35,89,0.393,15,25,0.6,0.592,20,26,0.769,8,68,76,26,20,7,8,41,155
Jarrett Culver,SG,20,MIN,63,35,1506,230,569,0.404,66,221,0.299,164,348,0.471,0.462,54,117,0.462,70,142,212,110,57,38,81,125,580
Seth Curry,SG,29,DAL,59,20,1448,266,532,0.5,136,300,0.453,130,232,0.56,0.628,74,88,0.841,26,113,139,119,36,8,60,101,742
Stephen Curry,PG,31,GSW,5,5,139,33,82,0.402,12,49,0.245,21,33,0.636,0.476,26,26,1,4,22,26,33,5,2,16,11,104
Troy Daniels,SG,28,TOT,42,0,457,62,159,0.39,40,113,0.354,22,46,0.478,0.516,10,16,0.625,12,34,46,14,8,3,9,30,174
Troy Daniels,SG,28,LAL,41,0,456,62,158,0.392,40,112,0.357,22,46,0.478,0.519,10,16,0.625,12,34,46,14,8,3,9,30,174
Troy Daniels,SG,28,DEN,1,0,1,0,1,0,0,1,0,0,0,,0,0,0,,0,0,0,0,0,0,0,0,0
Anthony Davis,PF,26,LAL,55,55,1889,508,994,0.511,65,194,0.335,443,800,0.554,0.544,386,457,0.845,124,393,517,172,82,134,135,138,1467
Ed Davis,C,30,UTA,25,0,268,14,34,0.412,0,0,,14,34,0.412,0.412,5,11,0.455,29,66,95,8,10,9,13,55,33
Terence Davis,SG,22,TOR,64,2,1087,181,391,0.463,88,222,0.396,93,169,0.55,0.575,45,52,0.865,46,171,217,107,32,12,65,104,495
Dewayne Dedmon,C,30,TOT,44,18,774,102,255,0.4,22,107,0.206,80,148,0.541,0.443,30,36,0.833,60,189,249,22,25,41,57,133,256
Dewayne Dedmon,C,30,SAC,34,10,541,69,171,0.404,14,71,0.197,55,100,0.55,0.444,23,28,0.821,46,121,167,15,15,26,47,93,175
Dewayne Dedmon,C,30,ATL,10,8,233,33,84,0.393,8,36,0.222,25,48,0.521,0.44,7,8,0.875,14,68,82,7,10,15,10,40,81
Matthew Dellavedova,PG,29,CLE,57,4,821,62,175,0.354,21,91,0.231,41,84,0.488,0.414,32,37,0.865,18,57,75,180,20,2,59,78,177
DeMar DeRozan,SF,30,SAS,61,61,2091,503,956,0.526,8,30,0.267,495,926,0.535,0.53,338,401,0.843,39,305,344,340,62,14,147,164,1352
Cheick Diallo,C,23,PHO,44,2,467,89,137,0.65,1,2,0.5,88,135,0.652,0.653,32,37,0.865,28,99,127,22,10,12,30,54,211
Hamidou Diallo,SF,21,OKC,38,3,699,99,219,0.452,7,35,0.2,92,184,0.5,0.468,28,45,0.622,29,93,122,22,28,8,37,82,233
Gorgui Dieng,C,30,TOT,58,17,1012,158,343,0.461,51,142,0.359,107,201,0.532,0.535,61,83,0.735,87,249,336,71,48,56,55,112,428
Gorgui Dieng,C,30,MIN,46,17,778,124,277,0.448,46,120,0.383,78,157,0.497,0.531,47,59,0.797,73,183,256,58,37,42,44,89,341
Gorgui Dieng,C,30,MEM,12,0,234,34,66,0.515,5,22,0.227,29,44,0.659,0.553,14,24,0.583,14,66,80,13,11,14,11,23,87
Spencer Dinwiddie,SG,26,BRK,64,49,1994,424,1021,0.415,123,400,0.308,301,621,0.485,0.476,347,446,0.778,32,189,221,432,40,21,174,180,1318
Donte DiVincenzo,SG,23,MIL,59,22,1362,209,452,0.462,76,221,0.344,133,231,0.576,0.546,60,78,0.769,59,230,289,136,80,18,72,97,554
Luka Dončić,PG,20,DAL,54,54,1799,512,1111,0.461,156,491,0.318,356,620,0.574,0.531,369,491,0.752,69,433,502,470,59,10,227,134,1549
Luguentz Dort,SG,20,OKC,29,21,637,65,157,0.414,22,73,0.301,43,84,0.512,0.484,28,36,0.778,15,39,54,21,23,2,15,78,180
Damyean Dotson,SG,25,NYK,48,0,836,120,290,0.414,59,163,0.362,61,127,0.48,0.516,22,33,0.667,10,81,91,57,23,4,21,44,321
Sekou Doumbouya,SF,19,DET,38,19,754,92,236,0.39,28,98,0.286,64,138,0.464,0.449,31,46,0.674,20,98,118,19,20,8,35,80,243
PJ Dozier,PG,23,DEN,21,0,234,36,91,0.396,7,28,0.25,29,63,0.46,0.434,7,11,0.636,5,25,30,29,7,5,11,27,86
Goran Dragić,PG,33,MIA,54,1,1531,290,663,0.437,118,313,0.377,172,350,0.491,0.526,170,221,0.769,26,140,166,273,31,8,133,105,868
Andre Drummond,C,26,TOT,57,56,1879,418,784,0.533,5,35,0.143,413,749,0.551,0.536,169,294,0.575,250,614,864,152,109,93,203,201,1010
Andre Drummond,C,26,DET,49,48,1654,360,679,0.53,1,21,0.048,359,658,0.546,0.531,149,255,0.584,226,549,775,138,97,82,174,176,870
Andre Drummond,C,26,CLE,8,8,225,58,105,0.552,4,14,0.286,54,91,0.593,0.571,20,39,0.513,24,65,89,14,12,11,29,25,140
Jared Dudley,SF,34,LAL,40,1,311,20,50,0.4,16,34,0.471,4,16,0.25,0.56,2,2,1,5,38,43,19,12,3,6,36,58
Kris Dunn,PG,25,CHI,51,32,1269,152,342,0.444,29,112,0.259,123,230,0.535,0.487,40,54,0.741,23,163,186,173,101,17,68,158,373
Carsen Edwards,SG,21,BOS,35,0,316,37,113,0.327,21,68,0.309,16,45,0.356,0.42,11,13,0.846,6,37,43,22,10,3,15,33,106
Henry Ellenson,PF,23,BRK,5,0,15,1,7,0.143,0,4,0,1,3,0.333,0.143,0,0,,2,4,6,1,0,0,0,1,2
Wayne Ellington,SG,32,NYK,36,1,558,61,174,0.351,50,143,0.35,11,31,0.355,0.494,11,13,0.846,4,61,65,44,13,4,18,41,183
Joel Embiid,C,25,PHI,44,44,1329,332,701,0.474,56,161,0.348,276,540,0.511,0.514,311,382,0.814,122,398,520,137,38,58,135,151,1031
James Ennis,SF,29,TOT,61,10,1053,128,294,0.435,47,139,0.338,81,155,0.523,0.515,63,78,0.808,61,138,199,54,29,20,43,109,366
James Ennis,SF,29,PHI,49,0,776,100,226,0.442,37,106,0.349,63,120,0.525,0.524,48,61,0.787,48,102,150,41,23,14,31,85,285
James Ennis,SF,29,ORL,12,10,277,28,68,0.412,10,33,0.303,18,35,0.514,0.485,15,17,0.882,13,36,49,13,6,6,12,24,81
Drew Eubanks,PF,22,SAS,14,3,130,21,28,0.75,1,1,1,20,27,0.741,0.768,8,11,0.727,8,27,35,5,2,6,10,21,51
Jacob Evans,SG,22,TOT,29,1,418,45,134,0.336,13,39,0.333,32,95,0.337,0.384,25,29,0.862,9,32,41,31,11,12,25,41,128
Jacob Evans,SG,22,GSW,27,1,414,45,133,0.338,13,38,0.342,32,95,0.337,0.387,25,29,0.862,9,32,41,31,11,12,25,41,128
Jacob Evans,SG,22,MIN,2,0,4,0,1,0,0,1,0,0,0,,0,0,0,,0,0,0,0,0,0,0,0,0
Dante Exum,SG,24,TOT,35,1,485,56,119,0.471,15,43,0.349,41,76,0.539,0.534,32,43,0.744,12,55,67,40,13,8,31,38,159
Dante Exum,SG,24,UTA,11,0,83,10,23,0.435,2,6,0.333,8,17,0.471,0.478,2,2,1,3,9,12,7,1,2,10,8,24
Dante Exum,SG,24,CLE,24,1,402,46,96,0.479,13,37,0.351,33,59,0.559,0.547,30,41,0.732,9,46,55,33,12,6,21,30,135
Tacko Fall,C,24,BOS,6,0,24,9,12,0.75,0,0,,9,12,0.75,0.75,1,3,0.333,0,11,11,0,0,2,3,5,19
Derrick Favors,C,28,NOP,45,43,1089,189,305,0.62,1,7,0.143,188,298,0.631,0.621,36,62,0.581,147,298,445,75,25,44,51,99,415
Cristiano Felício,PF,27,CHI,22,0,386,34,54,0.63,0,2,0,34,52,0.654,0.63,18,23,0.783,55,47,102,16,10,2,18,34,86
Terrance Ferguson,SF,21,OKC,50,37,1170,74,199,0.372,46,155,0.297,28,44,0.636,0.487,15,19,0.789,23,50,73,45,26,16,30,144,209
Bruno Fernando,C,21,ATL,56,13,713,103,199,0.518,5,37,0.135,98,162,0.605,0.53,29,51,0.569,67,131,198,49,18,17,42,107,240
Yogi Ferrell,PG,26,SAC,44,0,484,67,169,0.396,19,69,0.275,48,100,0.48,0.453,32,37,0.865,6,42,48,59,14,4,25,31,185
Dorian Finney-Smith,PF,26,DAL,64,61,1898,214,457,0.468,99,265,0.374,115,192,0.599,0.577,70,97,0.722,125,227,352,97,44,37,63,154,597
Bryn Forbes,SG,26,SAS,63,62,1579,242,581,0.417,148,381,0.388,94,200,0.47,0.544,75,90,0.833,12,114,126,108,33,0,57,113,707
Evan Fournier,SG,27,ORL,61,61,1931,408,869,0.47,165,406,0.406,243,463,0.525,0.564,168,205,0.82,17,140,157,193,70,14,120,147,1149
De'Aaron Fox,PG,22,SAC,45,43,1426,329,692,0.475,47,153,0.307,282,539,0.523,0.509,215,306,0.703,30,151,181,304,64,23,141,129,920
Melvin Frazier,SG,23,ORL,15,0,51,6,17,0.353,4,7,0.571,2,10,0.2,0.471,2,4,0.5,1,3,4,1,4,2,3,8,18
Michael Frazier,SG,25,HOU,8,0,66,4,11,0.364,2,8,0.25,2,3,0.667,0.455,4,6,0.667,1,2,3,1,2,0,2,13,14
Tim Frazier,PG,29,DET,27,11,355,34,94,0.362,10,30,0.333,24,64,0.375,0.415,19,24,0.792,9,24,33,93,14,4,36,42,97
Markelle Fultz,PG,21,ORL,64,59,1813,320,676,0.473,30,118,0.254,290,558,0.52,0.496,102,141,0.723,35,178,213,334,83,10,131,126,772
Wenyen Gabriel,PF,22,TOT,28,1,210,20,46,0.435,6,20,0.3,14,26,0.538,0.5,14,20,0.7,18,28,46,8,10,6,16,35,60
Wenyen Gabriel,PF,22,SAC,11,0,61,6,17,0.353,1,8,0.125,5,9,0.556,0.382,6,10,0.6,4,6,10,3,3,2,5,7,19
Wenyen Gabriel,PF,22,POR,17,1,149,14,29,0.483,5,12,0.417,9,17,0.529,0.569,8,10,0.8,14,22,36,5,7,4,11,28,41
Daniel Gafford,C,21,CHI,43,7,609,94,134,0.701,0,0,,94,134,0.701,0.701,32,60,0.533,52,54,106,21,13,56,29,98,220
Danilo Gallinari,PF,31,OKC,55,55,1690,329,749,0.439,165,403,0.409,164,346,0.474,0.549,234,264,0.886,32,270,302,113,40,4,70,66,1057
Langston Galloway,SG,28,DET,66,6,1702,236,542,0.435,132,331,0.399,104,211,0.493,0.557,73,85,0.859,33,116,149,101,48,11,40,96,677
Darius Garland,PG,20,CLE,59,59,1824,280,699,0.401,105,296,0.355,175,403,0.434,0.476,63,72,0.875,27,84,111,229,42,4,151,92,728
Marc Gasol,C,35,TOR,36,35,990,99,236,0.419,51,127,0.402,48,109,0.44,0.528,26,36,0.722,29,199,228,124,28,33,43,101,275
Rudy Gay,PF,33,SAS,60,5,1287,222,502,0.442,58,185,0.314,164,317,0.517,0.5,99,113,0.876,56,266,322,101,26,28,78,89,601
Paul George,SF,29,LAC,42,42,1222,291,674,0.432,133,333,0.399,158,341,0.463,0.53,165,187,0.882,22,219,241,162,56,20,113,101,880
Taj Gibson,C,34,NYK,62,56,1025,167,286,0.584,4,14,0.286,163,272,0.599,0.591,41,56,0.732,111,156,267,52,27,30,47,122,379
Harry Giles,PF,21,SAC,38,17,579,116,207,0.56,0,0,,116,207,0.56,0.56,33,43,0.767,33,126,159,49,21,14,35,100,265
Shai Gilgeous-Alexander,SG,21,OKC,63,63,2214,442,935,0.473,78,222,0.351,364,713,0.511,0.514,254,317,0.801,45,339,384,208,70,45,117,108,1216
Rudy Gobert,C,27,UTA,62,62,2142,353,506,0.698,0,0,,353,506,0.698,0.698,228,367,0.621,211,639,850,93,47,124,120,196,934
Brandon Goodwin,PG,24,ATL,34,1,430,76,190,0.4,26,87,0.299,50,103,0.485,0.468,28,30,0.933,11,61,72,51,12,4,29,43,206
Aaron Gordon,PF,24,ORL,58,58,1914,314,726,0.433,68,226,0.301,246,500,0.492,0.479,137,203,0.675,103,338,441,215,50,36,94,116,833
Eric Gordon,SG,31,HOU,34,13,972,162,438,0.37,92,288,0.319,70,150,0.467,0.475,78,103,0.757,8,57,65,52,22,12,36,68,494
Devonte' Graham,PG,24,CHO,63,53,2211,368,963,0.382,218,585,0.373,150,378,0.397,0.495,191,233,0.82,42,170,212,471,62,15,181,115,1145
Treveon Graham,SG,26,TOT,55,20,929,87,242,0.36,33,120,0.275,54,122,0.443,0.428,36,56,0.643,51,99,150,45,24,6,29,102,243
Treveon Graham,SG,26,MIN,33,20,663,62,175,0.354,20,83,0.241,42,92,0.457,0.411,27,37,0.73,29,71,100,30,17,2,19,66,171
Treveon Graham,SG,26,ATL,22,0,266,25,67,0.373,13,37,0.351,12,30,0.4,0.47,9,19,0.474,22,28,50,15,7,4,10,36,72
Jerami Grant,PF,25,DEN,64,22,1676,263,558,0.471,88,220,0.4,175,338,0.518,0.55,128,172,0.744,53,174,227,79,44,52,55,141,742
Josh Gray,PG,26,NOP,2,0,23,1,2,0.5,0,0,,1,2,0.5,0.5,0,0,,1,1,2,2,0,0,5,1,2
Danny Green,SG,32,LAL,61,61,1529,178,425,0.419,113,299,0.378,65,126,0.516,0.552,32,44,0.727,44,162,206,86,76,29,54,129,501
Draymond Green,PF,29,GSW,43,43,1222,123,316,0.389,36,129,0.279,87,187,0.465,0.446,63,83,0.759,23,243,266,266,59,33,98,110,345
JaMychal Green,PF,29,LAC,55,0,1130,125,302,0.414,74,204,0.363,51,98,0.52,0.536,32,44,0.727,75,273,348,43,25,20,45,146,356
Javonte Green,SF,26,BOS,44,1,414,49,98,0.5,6,23,0.261,43,75,0.573,0.531,23,36,0.639,18,62,80,23,23,7,18,37,127
Jeff Green,PF,33,TOT,40,2,754,116,261,0.444,48,138,0.348,68,123,0.553,0.536,57,73,0.781,23,90,113,32,21,15,36,65,337
Jeff Green,PF,33,UTA,30,2,553,75,195,0.385,34,104,0.327,41,91,0.451,0.472,49,63,0.778,14,67,81,20,12,10,27,46,233
Jeff Green,PF,33,HOU,10,0,201,41,66,0.621,14,34,0.412,27,32,0.844,0.727,8,10,0.8,9,23,32,12,9,5,9,19,104
Blake Griffin,PF,30,DET,18,18,512,88,250,0.352,27,111,0.243,61,139,0.439,0.406,76,98,0.776,17,67,84,59,7,7,40,27,279
Marko Guduric,SG,24,MEM,42,0,476,61,154,0.396,25,81,0.309,36,73,0.493,0.477,23,25,0.92,14,57,71,45,12,8,36,34,170
Kyle Guy,SG,22,SAC,2,0,4,1,2,0.5,0,1,0,1,1,1,0.5,0,0,,0,0,0,0,0,0,0,0,2
Rui Hachimura,PF,21,WAS,41,41,1217,218,456,0.478,20,73,0.274,198,383,0.517,0.5,92,111,0.829,63,185,248,70,34,7,41,89,548
Devon Hall,SG,24,OKC,5,0,20,1,5,0.2,0,2,0,1,3,0.333,0.2,3,4,0.75,0,1,1,3,0,0,1,1,5
Donta Hall,PF,22,DET,4,0,48,1,4,0.25,0,0,,1,4,0.25,0.25,4,6,0.667,6,9,15,2,1,1,2,9,6
Dusty Hannahs,SG,26,MEM,2,0,13,4,9,0.444,2,3,0.667,2,6,0.333,0.556,2,2,1,0,1,1,0,0,0,0,1,12
Tim Hardaway Jr.,SG,27,DAL,63,50,1815,346,792,0.437,185,455,0.407,161,337,0.478,0.554,121,151,0.801,23,175,198,124,39,5,61,105,998
James Harden,SG,30,HOU,61,61,2241,603,1386,0.435,271,769,0.352,332,617,0.538,0.533,619,719,0.861,64,324,388,450,106,53,273,206,2096
Maurice Harkless,SF,26,TOT,62,48,1427,142,283,0.502,34,98,0.347,108,185,0.584,0.562,39,66,0.591,55,185,240,68,58,33,53,148,357
Maurice Harkless,SF,26,LAC,50,38,1141,112,217,0.516,27,73,0.37,85,144,0.59,0.578,24,42,0.571,47,153,200,48,49,30,46,120,275
Maurice Harkless,SF,26,NYK,12,10,286,30,66,0.455,7,25,0.28,23,41,0.561,0.508,15,24,0.625,8,32,40,20,9,3,7,28,82
Jared Harper,PG,22,PHO,3,0,8,1,4,0.25,0,2,0,1,2,0.5,0.25,0,0,,0,0,0,0,0,0,0,0,2
Montrezl Harrell,C,26,LAC,63,2,1749,471,812,0.58,0,18,0,471,794,0.593,0.58,231,351,0.658,163,282,445,107,39,72,108,146,1173
Gary Harris,SG,25,DEN,56,55,1780,218,519,0.42,70,210,0.333,148,309,0.479,0.487,75,92,0.815,26,137,163,118,76,14,60,116,581
Joe Harris,SF,28,BRK,63,63,1946,332,705,0.471,152,369,0.412,180,336,0.536,0.579,62,83,0.747,60,212,272,130,38,16,93,138,878
Tobias Harris,PF,27,PHI,65,65,2243,494,1046,0.472,117,323,0.362,377,723,0.521,0.528,154,191,0.806,54,386,440,205,49,35,97,148,1259
Shaquille Harrison,SF,26,CHI,43,10,484,77,165,0.467,16,42,0.381,61,123,0.496,0.515,39,50,0.78,22,64,86,49,34,19,19,55,209
Josh Hart,SF,24,NOP,57,14,1563,200,481,0.416,111,325,0.342,89,156,0.571,0.531,68,91,0.747,54,316,370,94,59,21,65,144,579
Isaiah Hartenstein,C,21,HOU,23,2,266,44,67,0.657,0,5,0,44,62,0.71,0.657,19,28,0.679,29,61,90,18,9,12,16,41,107
Udonis Haslem,PF,39,MIA,3,0,21,1,6,0.167,0,2,0,1,4,0.25,0.167,3,4,0.75,0,8,8,1,0,0,0,3,5
Jaxson Hayes,C,19,NOP,56,12,951,155,235,0.66,1,4,0.25,154,231,0.667,0.662,109,173,0.63,82,141,223,51,23,53,41,142,420
Gordon Hayward,SF,29,BOS,45,45,1501,305,607,0.502,74,189,0.392,231,418,0.553,0.563,94,111,0.847,45,249,294,185,35,20,79,81,778
John Henson,PF,29,TOT,40,8,600,95,171,0.556,8,36,0.222,87,135,0.644,0.579,23,46,0.5,46,116,162,54,24,42,36,78,221
John Henson,PF,29,CLE,29,2,412,61,120,0.508,6,31,0.194,55,89,0.618,0.533,17,33,0.515,32,82,114,43,16,32,21,55,145
John Henson,PF,29,DET,11,6,188,34,51,0.667,2,5,0.4,32,46,0.696,0.686,6,13,0.462,14,34,48,11,8,10,15,23,76
Dewan Hernandez,C,23,TOR,4,0,11,1,5,0.2,0,1,0,1,4,0.25,0.2,2,2,1,2,5,7,0,1,0,1,6,4
Juan Hernangómez,PF,24,TOT,48,14,833,100,247,0.405,44,129,0.341,56,118,0.475,0.494,44,71,0.62,43,154,197,40,19,9,32,64,288
Juan Hernangómez,PF,24,DEN,34,0,422,38,110,0.345,15,60,0.25,23,50,0.46,0.414,16,25,0.64,24,71,95,22,5,5,18,29,107
Juan Hernangómez,PF,24,MIN,14,14,411,62,137,0.453,29,69,0.42,33,68,0.485,0.558,28,46,0.609,19,83,102,18,14,4,14,35,181
Willy Hernangómez,C,25,CHO,31,0,375,74,139,0.532,5,22,0.227,69,117,0.59,0.55,37,59,0.627,43,91,134,29,10,7,30,32,190
Tyler Herro,SG,20,MIA,47,6,1280,220,532,0.414,99,253,0.391,121,279,0.434,0.507,66,79,0.835,14,173,187,91,30,7,72,59,605
Kevin Hervey,PF,23,OKC,7,0,19,1,11,0.091,0,8,0,1,3,0.333,0.091,0,0,,0,2,2,1,0,0,0,1,2
Mario Hezonja,PF,24,POR,47,4,767,81,189,0.429,21,64,0.328,60,125,0.48,0.484,42,51,0.824,26,136,162,42,28,9,37,92,225
Buddy Hield,SG,27,SAC,64,44,2045,456,1062,0.429,244,618,0.395,212,444,0.477,0.544,112,131,0.855,57,249,306,197,60,17,150,150,1268
George Hill,PG,33,MIL,52,0,1103,178,336,0.53,73,152,0.48,105,184,0.571,0.638,69,83,0.831,45,109,154,151,42,4,49,75,498
Solomon Hill,SF,28,TOT,54,4,992,100,248,0.403,59,156,0.378,41,92,0.446,0.522,30,42,0.714,27,127,154,98,36,12,47,78,289
Solomon Hill,SF,28,MEM,48,3,901,96,233,0.412,56,147,0.381,40,86,0.465,0.532,26,38,0.684,24,120,144,94,31,7,40,73,274
Solomon Hill,SF,28,MIA,6,1,91,4,15,0.267,3,9,0.333,1,6,0.167,0.367,4,4,1,3,7,10,4,5,5,7,5,15
Jaylen Hoard,SF,20,POR,13,0,103,15,32,0.469,0,3,0,15,29,0.517,0.469,8,13,0.615,14,18,32,4,5,0,4,12,38
Aaron Holiday,PG,23,IND,58,26,1368,202,496,0.407,80,203,0.394,122,293,0.416,0.488,62,72,0.861,21,111,132,193,45,13,75,102,546
Jrue Holiday,SG,29,NOP,55,55,1922,421,931,0.452,115,322,0.357,306,609,0.502,0.514,119,170,0.7,70,198,268,378,92,44,158,125,1076
Justin Holiday,SG,30,IND,65,2,1617,190,432,0.44,122,288,0.424,68,144,0.472,0.581,46,59,0.78,30,176,206,87,75,42,40,119,548
Rondae Hollis-Jefferson,SF,25,TOR,52,5,998,139,295,0.471,2,17,0.118,137,278,0.493,0.475,95,129,0.736,102,152,254,90,44,22,49,105,375
Richaun Holmes,C,26,SAC,39,33,1125,210,321,0.654,0,0,,210,321,0.654,0.654,80,100,0.8,118,207,325,39,39,55,49,152,500
Rodney Hood,SF,27,POR,21,21,619,87,172,0.506,35,71,0.493,52,101,0.515,0.608,21,27,0.778,10,62,72,32,17,4,19,46,230
Al Horford,C,33,PHI,60,57,1848,289,654,0.442,89,264,0.337,200,390,0.513,0.51,55,73,0.753,92,320,412,244,52,55,65,128,722
Talen Horton-Tucker,SG,19,LAL,2,0,5,0,1,0,0,1,0,0,0,,0,0,0,,0,0,0,2,1,0,0,0,0
Danuel House,SF,26,HOU,58,47,1739,206,482,0.427,113,311,0.363,93,171,0.544,0.545,68,85,0.8,56,190,246,78,64,32,49,119,593
Dwight Howard,C,34,LAL,62,2,1193,188,257,0.732,3,5,0.6,185,252,0.734,0.737,89,180,0.494,156,301,457,42,27,76,73,200,468
William Howard,SG,26,HOU,2,0,13,0,4,0,0,4,0,0,0,,0,0,0,,0,2,2,1,0,0,1,1,0
Kevin Huerter,SG,21,ATL,56,48,1760,252,610,0.413,127,334,0.38,125,276,0.453,0.517,53,64,0.828,35,193,228,213,51,27,87,139,684
De'Andre Hunter,SF,22,ATL,63,62,2018,280,683,0.41,108,304,0.355,172,379,0.454,0.489,110,144,0.764,44,242,286,112,44,18,103,182,778
Chandler Hutchison,SF,23,CHI,28,10,527,80,175,0.457,12,38,0.316,68,137,0.496,0.491,46,78,0.59,18,90,108,26,27,7,27,47,218
Serge Ibaka,C,30,TOR,50,27,1377,323,623,0.518,66,166,0.398,257,457,0.562,0.571,89,119,0.748,104,310,414,73,24,42,100,138,801
Andre Iguodala,SG,36,MIA,14,0,259,25,51,0.49,9,24,0.375,16,27,0.593,0.578,2,8,0.25,10,43,53,28,8,16,17,28,61
Ersan İlyasova,PF,32,MIL,56,8,895,137,290,0.472,46,124,0.371,91,166,0.548,0.552,62,75,0.827,60,216,276,47,23,14,33,87,382
Joe Ingles,SF,32,UTA,64,37,1916,218,494,0.441,123,310,0.397,95,184,0.516,0.566,65,84,0.774,23,233,256,331,57,9,124,135,624
Brandon Ingram,PF,22,NOP,56,56,1919,469,1006,0.466,137,354,0.387,332,652,0.509,0.534,283,330,0.858,49,301,350,241,56,37,174,162,1358
Kyrie Irving,PG,27,BRK,20,20,658,199,416,0.478,56,142,0.394,143,274,0.522,0.546,94,102,0.922,22,81,103,128,27,10,52,53,548
Jonathan Isaac,SF,22,ORL,32,32,949,149,322,0.463,30,91,0.33,119,231,0.515,0.509,56,73,0.767,57,165,222,44,50,78,47,79,384
Wesley Iwundu,SF,25,ORL,45,18,810,77,194,0.397,21,67,0.313,56,127,0.441,0.451,62,76,0.816,23,90,113,46,25,11,18,62,237
Frank Jackson,PG,21,NOP,51,1,656,99,257,0.385,39,120,0.325,60,137,0.438,0.461,48,64,0.75,19,52,71,41,15,4,43,67,285
Jaren Jackson Jr.,C,20,MEM,54,54,1512,328,701,0.468,135,340,0.397,193,361,0.535,0.564,123,166,0.741,53,201,254,76,36,87,94,219,914
Josh Jackson,SG,22,MEM,18,0,357,68,155,0.439,23,72,0.319,45,83,0.542,0.513,29,44,0.659,11,47,58,31,18,9,25,39,188
Justin Jackson,PF,24,DAL,58,2,929,124,311,0.399,45,151,0.298,79,160,0.494,0.471,36,44,0.818,27,115,142,49,12,10,12,58,329
Reggie Jackson,PG,29,TOT,23,11,556,107,257,0.416,45,113,0.398,62,144,0.431,0.504,35,43,0.814,15,52,67,101,10,5,40,40,294
Reggie Jackson,PG,29,DET,14,10,381,76,198,0.384,31,82,0.378,45,116,0.388,0.462,26,33,0.788,11,30,41,72,8,1,23,21,209
Reggie Jackson,PG,29,LAC,9,1,175,31,59,0.525,14,31,0.452,17,28,0.607,0.644,9,10,0.9,4,22,26,29,2,4,17,19,85
Justin James,SG,23,SAC,34,0,218,33,78,0.423,9,26,0.346,24,52,0.462,0.481,10,21,0.476,6,24,30,16,6,9,8,16,85
LeBron James,PG,35,LAL,60,60,2094,586,1176,0.498,133,381,0.349,453,795,0.57,0.555,239,343,0.697,59,414,473,636,74,30,239,106,1544
Amile Jefferson,PF,26,ORL,18,0,74,5,14,0.357,0,0,,5,14,0.357,0.357,5,14,0.357,10,13,23,4,1,3,3,7,15
DaQuan Jeffries,SG,22,SAC,6,0,19,3,7,0.429,1,4,0.25,2,3,0.667,0.5,0,0,,1,0,1,1,1,0,0,3,7
Ty Jerome,PG,22,PHO,28,0,315,37,106,0.349,13,47,0.277,24,59,0.407,0.41,11,14,0.786,6,35,41,43,14,3,18,28,98
Alize Johnson,SF,23,IND,13,0,54,7,15,0.467,0,0,,7,15,0.467,0.467,4,6,0.667,7,11,18,2,0,0,3,6,18
B.J. Johnson,SF,24,ORL,8,0,46,5,18,0.278,1,6,0.167,4,12,0.333,0.306,2,2,1,1,5,6,2,2,0,3,0,13
Cameron Johnson,PF,23,PHO,49,1,996,136,325,0.418,91,229,0.397,45,96,0.469,0.558,35,46,0.761,39,101,140,52,30,16,29,72,398
James Johnson,PF,32,TOT,32,1,619,103,215,0.479,33,91,0.363,70,124,0.565,0.556,31,48,0.646,25,93,118,74,25,32,48,80,270
James Johnson,PF,32,MIA,18,0,281,39,87,0.448,16,45,0.356,23,42,0.548,0.54,8,14,0.571,8,44,52,21,6,13,15,34,102
James Johnson,PF,32,MIN,14,1,338,64,128,0.5,17,46,0.37,47,82,0.573,0.566,23,34,0.676,17,49,66,53,19,19,33,46,168
Keldon Johnson,SF,20,SAS,9,0,92,16,31,0.516,2,5,0.4,14,26,0.538,0.548,7,10,0.7,5,12,17,6,5,1,3,9,41
Stanley Johnson,PF,23,TOR,20,0,96,8,31,0.258,2,13,0.154,6,18,0.333,0.29,5,6,0.833,3,19,22,8,4,2,8,10,23
Tyler Johnson,SG,27,PHO,31,3,515,65,171,0.38,24,83,0.289,41,88,0.466,0.45,24,32,0.75,10,42,52,50,12,8,24,43,178
Nikola Jokić,C,24,DEN,65,65,2101,512,969,0.528,71,226,0.314,441,743,0.594,0.565,218,268,0.813,155,508,663,446,77,43,202,200,1313
Damian Jones,C,24,ATL,55,27,887,121,178,0.68,2,9,0.222,119,169,0.704,0.685,62,84,0.738,74,132,206,35,26,40,28,149,306
Derrick Jones Jr.,SF,22,MIA,51,15,1249,166,323,0.514,34,126,0.27,132,197,0.67,0.567,88,113,0.779,57,156,213,57,54,36,27,114,454
Tyus Jones,PG,23,MEM,65,6,1232,197,429,0.459,47,124,0.379,150,305,0.492,0.514,43,58,0.741,9,94,103,285,59,6,55,44,484
DeAndre Jordan,C,31,BRK,56,6,1234,191,287,0.666,0,0,,191,287,0.666,0.666,83,122,0.68,141,420,561,105,18,52,74,114,465
Cory Joseph,PG,28,SAC,64,22,1538,155,369,0.42,47,134,0.351,108,235,0.46,0.484,48,58,0.828,37,126,163,218,46,21,64,121,405
Mfiondu Kabengele,C,22,LAC,12,0,64,14,32,0.438,9,20,0.45,5,12,0.417,0.578,5,5,1,1,10,11,2,2,2,2,9,42
Frank Kaminsky,C,26,PHO,32,13,718,127,279,0.455,39,112,0.348,88,167,0.527,0.525,59,88,0.67,30,128,158,71,13,10,33,69,352
Enes Kanter,C,27,BOS,51,6,891,176,311,0.566,1,7,0.143,175,304,0.576,0.568,63,89,0.708,141,253,394,49,21,38,52,85,416
Luke Kennard,SG,23,DET,28,25,922,151,342,0.442,73,183,0.399,78,159,0.491,0.548,67,75,0.893,9,89,98,115,12,6,43,65,442
Stanton Kidd,SF,27,UTA,4,0,15,0,3,0,0,1,0,0,2,0,0,0,0,,0,3,3,1,0,0,2,3,0
Michael Kidd-Gilchrist,PF-SF,26,TOT,21,0,231,19,60,0.317,5,20,0.25,14,40,0.35,0.358,9,11,0.818,12,43,55,13,2,5,13,32,52
Michael Kidd-Gilchrist,PF,26,CHO,12,0,160,18,53,0.34,5,17,0.294,13,36,0.361,0.387,7,9,0.778,9,26,35,10,0,3,7,18,48
Michael Kidd-Gilchrist,SF,26,DAL,9,0,71,1,7,0.143,0,3,0,1,4,0.25,0.143,2,2,1,3,17,20,3,2,2,6,14,4
Louis King,SF,20,DET,10,0,62,8,21,0.381,4,11,0.364,4,10,0.4,0.476,0,3,0,1,9,10,5,2,0,2,10,20
Maxi Kleber,C,28,DAL,66,21,1695,214,466,0.459,107,286,0.374,107,180,0.594,0.574,69,80,0.863,99,256,355,77,20,78,48,153,604
Brandon Knight,PG,28,TOT,25,3,462,59,167,0.353,45,131,0.344,14,36,0.389,0.488,20,34,0.588,4,37,41,69,10,3,38,40,183
Brandon Knight,PG,28,CLE,16,0,241,28,86,0.326,19,64,0.297,9,22,0.409,0.436,4,13,0.308,3,17,20,31,5,2,16,20,79
Brandon Knight,PG,28,DET,9,3,221,31,81,0.383,26,67,0.388,5,14,0.357,0.543,16,21,0.762,1,20,21,38,5,1,22,20,104
Kevin Knox,SF,20,NYK,65,4,1166,144,401,0.359,65,199,0.327,79,202,0.391,0.44,66,101,0.653,28,156,184,61,23,28,45,106,419
John Konchar,SG,23,MEM,15,0,167,23,35,0.657,4,9,0.444,19,26,0.731,0.714,1,2,0.5,18,28,46,21,7,3,6,7,51
Furkan Korkmaz,SG,22,PHI,64,12,1398,222,514,0.432,126,317,0.397,96,197,0.487,0.554,53,72,0.736,16,132,148,70,36,15,52,89,623
Luke Kornet,C,24,CHI,36,14,559,82,187,0.439,31,108,0.287,51,79,0.646,0.521,20,28,0.714,22,62,84,32,11,26,14,54,215
Kyle Korver,SF,38,MIL,50,0,833,111,259,0.429,86,207,0.415,25,52,0.481,0.595,28,34,0.824,14,90,104,61,21,12,42,68,336
Rodions Kurucs,PF,21,BRK,39,4,501,60,134,0.448,25,65,0.385,35,69,0.507,0.541,17,28,0.607,18,79,97,33,17,3,35,66,162
Kyle Kuzma,PF,24,LAL,54,7,1327,254,588,0.432,70,236,0.297,184,352,0.523,0.491,96,130,0.738,48,194,242,69,21,21,85,106,674
Skal Labissière,C,23,POR,33,1,567,81,147,0.551,3,13,0.231,78,134,0.582,0.561,25,33,0.758,65,104,169,42,7,31,30,89,190
Jeremy Lamb,SG,27,IND,46,42,1291,216,479,0.451,53,158,0.335,163,321,0.508,0.506,92,110,0.836,24,176,200,96,55,22,50,104,577
Romeo Langford,SG,20,BOS,27,1,298,24,64,0.375,5,23,0.217,19,41,0.463,0.414,16,23,0.696,14,18,32,6,8,6,9,29,69
Zach LaVine,SG,24,CHI,60,60,2085,539,1199,0.45,184,484,0.38,355,715,0.497,0.526,268,334,0.802,41,248,289,254,88,28,206,131,1530
Vic Law,SF,24,ORL,5,0,9,0,3,0,0,1,0,0,2,0,0,0,2,0,0,1,1,0,0,0,0,0,0
Jake Layman,PF,25,MIN,23,2,505,81,179,0.453,24,72,0.333,57,107,0.533,0.52,24,32,0.75,17,40,57,15,17,10,24,47,210
T.J. Leaf,PF,22,IND,25,1,193,30,69,0.435,5,14,0.357,25,55,0.455,0.471,7,12,0.583,21,43,64,6,8,3,7,18,72
Jalen Lecque,PG,19,PHO,4,0,26,4,10,0.4,0,4,0,4,6,0.667,0.4,2,2,1,0,0,0,2,0,0,1,2,10
Courtney Lee,SG,34,DAL,24,9,345,40,82,0.488,21,47,0.447,19,35,0.543,0.616,6,7,0.857,7,25,32,12,18,6,11,33,107
Damion Lee,SG,27,GSW,49,36,1423,213,511,0.417,85,239,0.356,128,272,0.471,0.5,110,126,0.873,32,207,239,133,50,6,67,116,621
Alex Len,C,26,TOT,49,9,895,168,302,0.556,14,56,0.25,154,246,0.626,0.579,58,91,0.637,95,199,294,47,22,46,50,114,408
Alex Len,C,26,ATL,40,9,745,142,260,0.546,14,56,0.25,128,204,0.627,0.573,51,81,0.63,69,161,230,42,20,33,39,93,349
Alex Len,C,26,SAC,9,0,150,26,42,0.619,0,0,,26,42,0.619,0.619,7,10,0.7,26,38,64,5,2,13,11,21,59
Kawhi Leonard,SF,28,LAC,51,51,1643,476,1016,0.469,107,292,0.366,369,724,0.51,0.521,311,350,0.889,52,321,373,254,92,31,140,98,1370
Meyers Leonard,C,27,MIA,49,49,987,116,223,0.52,51,119,0.429,65,104,0.625,0.635,17,26,0.654,27,221,248,53,13,15,35,103,300
Caris LeVert,SG,25,BRK,39,25,1131,252,609,0.414,72,189,0.381,180,420,0.429,0.473,116,161,0.72,40,119,159,159,44,7,98,72,692
Damian Lillard,PG,29,POR,58,58,2140,531,1162,0.457,226,573,0.394,305,589,0.518,0.554,389,438,0.888,30,220,250,453,59,21,168,98,1677
Nassir Little,PF,19,POR,48,5,573,65,151,0.43,14,59,0.237,51,92,0.554,0.477,28,44,0.636,31,77,108,22,13,14,15,72,172
Kevon Looney,C,23,GSW,20,4,262,29,79,0.367,1,14,0.071,28,65,0.431,0.373,9,12,0.75,28,38,66,20,12,6,12,34,68
Brook Lopez,C,31,MIL,61,60,1622,244,571,0.427,84,284,0.296,160,287,0.557,0.501,98,121,0.81,42,230,272,95,43,149,63,147,670
Robin Lopez,C,31,MIL,60,4,862,137,273,0.502,33,96,0.344,104,177,0.588,0.562,23,43,0.535,52,94,146,41,10,41,54,80,330
Kevin Love,PF,31,CLE,56,56,1780,327,727,0.45,146,390,0.374,181,337,0.537,0.55,187,219,0.854,54,493,547,178,33,19,140,90,987
Kyle Lowry,PG,33,TOR,52,52,1901,309,741,0.417,153,432,0.354,156,309,0.505,0.52,255,296,0.861,30,221,251,399,70,22,154,168,1026
Timothé Luwawu-Cabarrot,SG,24,BRK,39,0,671,78,192,0.406,39,109,0.358,39,83,0.47,0.508,52,62,0.839,24,67,91,25,15,6,32,81,247
Trey Lyles,PF,24,SAS,63,53,1271,153,343,0.446,65,168,0.387,88,175,0.503,0.541,33,45,0.733,71,290,361,69,28,28,39,98,404
Daryl Macon,SG,24,MIA,4,0,14,1,3,0.333,1,2,0.5,0,1,0,0.5,0,0,,0,0,0,1,0,0,2,1,3
J.P. Macura,SG,24,CLE,1,0,1,0,0,,0,0,,0,0,,,0,0,,0,0,0,0,0,0,0,0,0
Josh Magette,PG,30,ORL,8,0,38,5,15,0.333,1,4,0.25,4,11,0.364,0.367,1,2,0.5,1,5,6,5,3,1,5,4,12
Ian Mahinmi,C,33,WAS,38,35,808,104,210,0.495,5,26,0.192,99,184,0.538,0.507,70,113,0.619,78,140,218,49,31,44,45,114,283
Thon Maker,C,22,DET,60,14,776,93,193,0.482,22,64,0.344,71,129,0.55,0.539,73,110,0.664,54,113,167,43,25,39,45,102,281
Terance Mann,SG,23,LAC,35,6,271,22,54,0.407,3,12,0.25,19,42,0.452,0.435,9,12,0.75,4,29,33,38,8,5,14,36,56
Boban Marjanović,C,31,DAL,37,2,337,96,173,0.555,4,15,0.267,92,158,0.582,0.566,36,47,0.766,53,100,153,13,7,7,26,47,232
Lauri Markkanen,PF,22,CHI,50,50,1492,251,591,0.425,109,317,0.344,142,274,0.518,0.517,126,153,0.824,60,253,313,74,42,23,81,96,737
Caleb Martin,SF,24,CHO,18,1,317,37,84,0.44,20,37,0.541,17,47,0.362,0.56,17,21,0.81,10,28,38,23,12,7,15,32,111
Cody Martin,SF,24,CHO,48,3,903,89,207,0.43,18,77,0.234,71,130,0.546,0.473,42,65,0.646,38,120,158,95,39,9,44,78,238
Jeremiah Martin,PG,23,BRK,3,0,16,1,5,0.2,0,1,0,1,4,0.25,0.2,0,0,,0,2,2,2,1,1,0,0,2
Kelan Martin,SF,24,MIN,31,4,495,71,181,0.392,25,96,0.26,46,85,0.541,0.461,30,31,0.968,12,84,96,23,7,9,20,51,197
Frank Mason III,PG,25,MIL,6,0,53,5,19,0.263,2,10,0.2,3,9,0.333,0.316,2,4,0.5,3,5,8,11,2,0,6,4,14
Garrison Mathews,SG,23,WAS,18,0,227,24,56,0.429,19,46,0.413,5,10,0.5,0.598,31,34,0.912,6,18,24,10,8,1,8,32,98
Wesley Matthews,SG,33,MIL,62,62,1529,159,401,0.397,101,277,0.365,58,124,0.468,0.522,48,63,0.762,21,139,160,91,37,9,41,91,467
Patrick McCaw,SF,24,TOR,37,12,908,67,162,0.414,23,71,0.324,44,91,0.484,0.485,13,18,0.722,19,67,86,79,39,4,29,60,170
CJ McCollum,SG,28,POR,62,62,2229,549,1212,0.453,174,458,0.38,375,754,0.497,0.525,123,164,0.75,41,213,254,268,46,39,116,159,1395
T.J. McConnell,PG,27,IND,63,3,1188,187,362,0.517,5,15,0.333,182,347,0.524,0.523,30,36,0.833,32,131,163,316,44,11,86,69,409
Jalen McDaniels,PF,22,CHO,16,0,293,33,70,0.471,9,24,0.375,24,46,0.522,0.536,14,17,0.824,15,50,65,13,8,3,11,36,89
Doug McDermott,PF,28,IND,62,0,1242,241,491,0.491,118,265,0.445,123,226,0.544,0.611,43,52,0.827,23,133,156,70,9,4,40,106,643
JaVale McGee,C,32,LAL,61,61,1023,181,283,0.64,3,6,0.5,178,277,0.643,0.645,49,75,0.653,111,243,354,34,31,92,47,145,414
Rodney McGruder,SG,28,LAC,50,3,749,61,156,0.391,22,79,0.278,39,77,0.506,0.462,15,28,0.536,26,102,128,30,23,8,21,67,159
Alfonzo McKinnie,SF,27,CLE,40,1,593,73,171,0.427,14,65,0.215,59,106,0.557,0.468,22,31,0.71,37,76,113,14,23,8,26,72,182
Jordan McLaughlin,PG,23,MIN,30,2,590,87,178,0.489,29,76,0.382,58,102,0.569,0.57,26,39,0.667,7,42,49,125,34,4,31,31,229
Ben McLemore,SG,26,HOU,63,19,1437,209,470,0.445,154,390,0.395,55,80,0.688,0.609,47,62,0.758,20,119,139,54,38,12,46,130,619
Jordan McRae,SG,28,TOT,37,4,784,149,366,0.407,45,126,0.357,104,240,0.433,0.469,83,109,0.761,18,106,124,93,21,16,43,73,426
Jordan McRae,SG,28,WAS,29,4,654,133,317,0.42,40,106,0.377,93,211,0.441,0.483,64,83,0.771,17,87,104,82,19,15,38,61,370
Jordan McRae,SG,28,DEN,4,0,32,2,6,0.333,2,4,0.5,0,2,0,0.5,3,4,0.75,1,4,5,4,2,1,0,2,9
Jordan McRae,SG,28,DET,4,0,98,14,43,0.326,3,16,0.188,11,27,0.407,0.36,16,22,0.727,0,15,15,7,0,0,5,10,47
Nicolò Melli,C,29,NOP,52,6,889,123,278,0.442,65,180,0.361,58,98,0.592,0.559,44,60,0.733,37,120,157,67,30,19,42,105,355
De'Anthony Melton,PG,21,MEM,52,8,1011,148,353,0.419,37,117,0.316,111,236,0.47,0.472,87,106,0.821,37,156,193,157,65,18,78,92,420
Chimezie Metu,PF,22,SAS,16,0,73,20,35,0.571,0,1,0,20,34,0.588,0.571,6,8,0.75,10,16,26,6,1,4,5,4,46
Khris Middleton,SF,28,MIL,55,52,1653,424,850,0.499,133,318,0.418,291,532,0.547,0.577,178,196,0.908,40,301,341,225,51,7,113,122,1159
Eric Mika,PF,25,SAC,1,0,19,2,3,0.667,0,0,,2,3,0.667,0.667,2,2,1,2,5,7,0,0,0,0,5,6
C.J. Miles,SG,32,WAS,10,0,161,19,59,0.322,11,35,0.314,8,24,0.333,0.415,15,20,0.75,4,8,12,12,10,4,4,14,64
Malcolm Miller,SF,26,TOR,25,1,125,8,24,0.333,6,19,0.316,2,5,0.4,0.458,1,6,0.167,1,13,14,8,4,2,3,12,23
Patty Mills,PG,31,SAS,63,1,1430,247,576,0.429,148,389,0.38,99,187,0.529,0.557,93,108,0.861,19,80,99,112,52,6,51,98,735
Paul Millsap,PF,34,DEN,44,41,1075,188,387,0.486,48,109,0.44,140,278,0.504,0.548,105,126,0.833,87,173,260,70,38,28,61,127,529
Shake Milton,SG,23,PHI,32,16,611,108,217,0.498,48,106,0.453,60,111,0.541,0.608,39,51,0.765,11,57,68,71,19,6,38,69,303
Donovan Mitchell,SG,23,UTA,63,63,2165,560,1235,0.453,156,428,0.364,404,807,0.501,0.517,249,290,0.859,44,232,276,264,66,12,167,154,1525
Naz Mitrou-Long,SG,26,IND,3,0,43,6,16,0.375,2,11,0.182,4,5,0.8,0.438,0,0,,0,6,6,7,1,1,2,1,14
Adam Mokoka,SG,21,CHI,11,0,112,12,28,0.429,6,15,0.4,6,13,0.462,0.536,2,4,0.5,7,3,10,4,4,0,2,17,32
Malik Monk,SG,21,CHO,55,1,1169,212,488,0.434,58,204,0.284,154,284,0.542,0.494,82,100,0.82,27,130,157,114,25,16,77,74,564
Matt Mooney,SG,22,CLE,4,0,19,1,4,0.25,0,2,0,1,2,0.5,0.25,0,0,,0,3,3,1,2,1,0,1,2
E'Twaun Moore,SG,30,NOP,51,5,958,174,410,0.424,60,160,0.375,114,250,0.456,0.498,29,43,0.674,29,94,123,73,28,10,38,77,437
Ja Morant,PG,20,MEM,59,59,1771,393,800,0.491,51,139,0.367,342,661,0.517,0.523,204,265,0.77,44,164,208,409,54,15,191,90,1041
Juwan Morgan,PF,22,UTA,16,0,74,9,17,0.529,1,5,0.2,8,12,0.667,0.559,0,0,,5,14,19,2,0,1,3,7,19
Marcus Morris,SF-PF,30,TOT,55,55,1727,325,750,0.433,133,324,0.41,192,426,0.451,0.522,172,209,0.823,55,226,281,77,42,27,88,161,955
Marcus Morris,SF,30,NYK,43,43,1387,281,636,0.442,116,264,0.439,165,372,0.444,0.533,163,198,0.823,48,185,233,59,34,17,73,128,841
Marcus Morris,PF,30,LAC,12,12,340,44,114,0.386,17,60,0.283,27,54,0.5,0.461,9,11,0.818,7,41,48,18,8,10,15,33,114
Markieff Morris,PF,30,TOT,52,16,1106,189,425,0.445,81,210,0.386,108,215,0.502,0.54,65,83,0.783,34,165,199,74,28,15,75,120,524
Markieff Morris,PF,30,DET,44,16,988,175,389,0.45,75,189,0.397,100,200,0.5,0.546,61,79,0.772,24,149,173,69,26,11,70,104,486
Markieff Morris,PF,30,LAL,8,0,118,14,36,0.389,6,21,0.286,8,15,0.533,0.472,4,4,1,10,16,26,5,2,4,5,16,38
Monte Morris,PG,24,DEN,65,8,1402,222,484,0.459,54,144,0.375,168,340,0.494,0.514,51,62,0.823,20,92,112,230,53,16,45,64,549
Johnathan Motley,PF,24,LAC,13,0,41,11,15,0.733,1,1,1,10,14,0.714,0.767,5,7,0.714,3,7,10,8,3,0,5,6,28
Emmanuel Mudiay,PG,23,UTA,48,1,752,136,289,0.471,27,76,0.355,109,213,0.512,0.517,52,69,0.754,17,98,115,107,19,10,65,64,351
Mychal Mulder,SG,25,GSW,7,3,204,26,67,0.388,16,52,0.308,10,15,0.667,0.507,9,12,0.75,3,20,23,8,2,1,5,20,77
Dejounte Murray,PG,23,SAS,58,50,1447,255,537,0.475,34,90,0.378,221,447,0.494,0.507,75,94,0.798,67,268,335,237,100,16,108,128,619
Jamal Murray,PG,22,DEN,55,55,1804,385,846,0.455,105,304,0.345,280,542,0.517,0.517,158,177,0.893,42,175,217,266,64,16,124,97,1033
Džanan Musa,SF,20,BRK,35,0,404,50,139,0.36,15,65,0.231,35,74,0.473,0.414,33,44,0.75,19,52,71,31,13,1,29,25,148
Mike Muscala,C,28,OKC,41,0,492,64,159,0.403,43,120,0.358,21,39,0.538,0.538,18,22,0.818,13,81,94,34,8,11,14,51,189
Sviatoslav Mykhailiuk,SF,22,DET,56,27,1265,166,405,0.41,115,285,0.404,51,120,0.425,0.552,57,70,0.814,17,87,104,106,41,4,61,87,504
Abdel Nader,SF,26,OKC,48,5,756,100,220,0.455,39,105,0.371,61,115,0.53,0.543,48,62,0.774,14,76,90,35,20,20,36,65,287
Larry Nance Jr.,C,27,CLE,56,10,1472,229,431,0.531,56,159,0.352,173,272,0.636,0.596,50,74,0.676,106,303,409,123,56,22,60,91,564
Shabazz Napier,PG,28,TOT,51,30,1234,170,413,0.412,71,222,0.32,99,191,0.518,0.498,116,141,0.823,25,121,146,253,66,9,111,93,527
Shabazz Napier,PG,28,MIN,36,22,856,114,283,0.403,47,159,0.296,67,124,0.54,0.486,72,88,0.818,17,93,110,187,40,7,76,62,347
Shabazz Napier,PG,28,WAS,15,8,378,56,130,0.431,24,63,0.381,32,67,0.478,0.523,44,53,0.83,8,28,36,66,26,2,35,31,180
Raul Neto,PG,27,PHI,49,3,565,79,175,0.451,28,71,0.394,51,104,0.49,0.531,26,31,0.839,11,41,52,77,22,5,42,43,212
Malik Newman,SG,22,CLE,1,0,4,0,2,0,0,1,0,0,1,0,0,2,2,1,0,0,0,0,0,0,1,0,2
Georges Niang,PF,26,UTA,58,0,772,120,265,0.453,77,185,0.416,43,80,0.538,0.598,19,22,0.864,12,97,109,35,13,5,26,63,336
Nerlens Noel,C,25,OKC,55,6,1014,174,254,0.685,1,3,0.333,173,251,0.689,0.687,75,98,0.765,82,189,271,53,56,82,54,143,424
Zach Norvell,SG,22,TOT,5,0,41,3,12,0.25,3,8,0.375,0,4,0,0.375,1,1,1,0,6,6,3,2,0,3,4,10
Zach Norvell,SG,22,LAL,2,0,5,0,1,0,0,0,,0,1,0,0,0,0,,0,1,1,0,0,0,0,0,0
Zach Norvell,SG,22,GSW,3,0,36,3,11,0.273,3,8,0.375,0,3,0,0.409,1,1,1,0,5,5,3,2,0,3,4,10
Jaylen Nowell,SG,20,MIN,15,0,151,19,53,0.358,3,26,0.115,16,27,0.593,0.387,16,17,0.941,3,10,13,19,3,1,3,11,57
Frank Ntilikina,PG,21,NYK,57,26,1187,131,333,0.393,44,137,0.321,87,196,0.444,0.459,51,59,0.864,23,98,121,172,54,16,71,142,357
Kendrick Nunn,SG,24,MIA,62,62,1846,381,850,0.448,131,362,0.362,250,488,0.512,0.525,77,92,0.837,19,149,168,210,51,11,101,142,970
David Nwaba,SF,27,BRK,20,0,268,37,71,0.521,12,28,0.429,25,43,0.581,0.606,18,27,0.667,8,37,45,8,11,12,8,32,104
Royce O'Neale,PF,26,UTA,64,55,1862,141,321,0.439,82,211,0.389,59,110,0.536,0.567,36,49,0.735,22,317,339,163,47,28,50,180,400
Kyle O'Quinn,C,29,PHI,26,1,258,35,72,0.486,7,23,0.304,28,49,0.571,0.535,10,19,0.526,32,66,98,35,5,22,18,35,87
Semi Ojeleye,PF,25,BOS,61,5,891,65,159,0.409,36,98,0.367,29,61,0.475,0.522,25,28,0.893,24,100,124,31,18,5,12,63,191
Jahlil Okafor,C,24,NOP,28,9,424,88,144,0.611,1,2,0.5,87,142,0.613,0.615,37,58,0.638,46,73,119,36,7,19,36,63,214
Elie Okobo,PG,22,PHO,54,3,707,72,181,0.398,25,71,0.352,47,110,0.427,0.467,46,67,0.687,16,72,88,113,24,4,38,53,215
Josh Okogie,SG,21,MIN,62,28,1547,170,398,0.427,41,154,0.266,129,244,0.529,0.479,152,191,0.796,87,181,268,99,68,26,87,139,533
KZ Okpala,SF,20,MIA,5,0,26,3,5,0.6,0,1,0,3,4,0.75,0.6,1,2,0.5,1,4,5,1,2,1,1,2,7
Victor Oladipo,SG,27,IND,13,10,337,63,161,0.391,21,69,0.304,42,92,0.457,0.457,32,41,0.78,7,34,41,39,11,3,28,21,179
Kelly Olynyk,C,28,MIA,59,6,1089,151,317,0.476,80,185,0.432,71,132,0.538,0.603,70,82,0.854,37,222,259,97,38,18,63,144,452
Miye Oni,SG,22,UTA,5,0,11,0,2,0,0,1,0,0,1,0,0,0,0,,0,2,2,0,0,0,1,0,0
Cedi Osman,SF,24,CLE,65,65,1910,266,609,0.437,123,321,0.383,143,288,0.497,0.538,63,94,0.67,39,192,231,154,54,16,91,160,718
Kelly Oubre Jr.,SF,24,PHO,56,55,1933,373,826,0.452,108,307,0.352,265,519,0.511,0.517,192,246,0.78,67,294,361,85,71,40,83,192,1046
Tariq Owens,PF,24,PHO,3,0,15,1,5,0.2,0,2,0,1,3,0.333,0.2,2,2,1,2,1,3,0,1,0,0,1,4
Jeremy Pargo,PG,33,GSW,3,0,44,11,22,0.5,3,7,0.429,8,15,0.533,0.568,0,1,0,1,2,3,8,1,0,4,8,25
Jabari Parker,PF,24,TOT,33,23,852,199,399,0.499,31,116,0.267,168,283,0.594,0.538,55,74,0.743,54,141,195,60,42,15,60,94,484
Jabari Parker,PF,24,ATL,32,23,837,198,393,0.504,31,115,0.27,167,278,0.601,0.543,53,72,0.736,54,137,191,58,42,15,60,93,480
Jabari Parker,PF,24,SAC,1,0,15,1,6,0.167,0,1,0,1,5,0.2,0.167,2,2,1,0,4,4,2,0,0,0,1,4
Chandler Parsons,SF,31,ATL,5,0,54,5,18,0.278,4,14,0.286,1,4,0.25,0.389,0,0,,1,6,7,3,4,1,3,3,14
Eric Paschall,PF,23,GSW,60,26,1654,318,640,0.497,37,129,0.287,281,511,0.55,0.526,164,212,0.774,82,193,275,127,32,13,94,125,837
Anžejs Pasečņiks,C,24,WAS,24,0,405,56,106,0.528,0,2,0,56,104,0.538,0.528,32,54,0.593,39,60,99,17,8,12,22,65,144
Patrick Patterson,PF,30,LAC,51,18,607,76,188,0.404,55,142,0.387,21,46,0.457,0.551,27,34,0.794,30,91,121,31,6,3,18,41,234
Justin Patton,C,22,OKC,5,0,24,4,10,0.4,1,4,0.25,3,6,0.5,0.45,0,0,,1,4,5,2,0,0,2,4,9
Chris Paul,PG,34,OKC,63,63,2003,394,805,0.489,101,279,0.362,293,526,0.557,0.552,225,250,0.9,21,289,310,426,98,9,137,139,1114
Elfrid Payton,PG,25,NYK,45,36,1246,193,440,0.439,14,69,0.203,179,371,0.482,0.455,49,86,0.57,52,160,212,323,70,17,96,89,449
Gary Payton II,PG,27,WAS,29,17,432,48,116,0.414,13,46,0.283,35,70,0.5,0.47,4,8,0.5,26,54,80,48,33,7,20,54,113
Norvel Pelle,C,26,PHI,20,0,178,18,35,0.514,0,0,,18,35,0.514,0.514,6,12,0.5,16,44,60,7,1,25,13,39,42
Theo Pinson,SG,24,BRK,33,0,365,45,155,0.29,15,80,0.188,30,75,0.4,0.339,15,16,0.938,10,44,54,56,17,4,33,35,120
Mason Plumlee,C,29,DEN,53,1,900,153,248,0.617,0,4,0,153,244,0.627,0.617,74,138,0.536,89,193,282,125,29,33,72,125,380
Jakob Poeltl,C,24,SAS,58,10,965,135,218,0.619,0,0,,135,218,0.619,0.619,36,74,0.486,104,206,310,102,30,84,45,96,306
Vincent Poirier,C,26,BOS,21,0,114,16,33,0.485,1,2,0.5,15,31,0.484,0.5,6,7,0.857,10,24,34,7,2,6,6,23,39
Shamorie Ponds,PG,21,TOR,4,0,11,3,5,0.6,1,2,0.5,2,3,0.667,0.7,2,2,1,0,1,1,2,0,1,0,2,9
Jordan Poole,SG,20,GSW,57,14,1274,167,502,0.333,74,265,0.279,93,237,0.392,0.406,95,119,0.798,9,109,118,134,35,10,74,94,503
Kevin Porter Jr.,SF,19,CLE,50,3,1162,186,421,0.442,53,158,0.335,133,263,0.506,0.505,73,101,0.723,22,140,162,109,46,14,93,135,498
Michael Porter Jr.,PF,21,DEN,48,1,670,141,285,0.495,43,102,0.422,98,183,0.536,0.57,33,43,0.767,53,146,199,35,20,19,35,75,358
Otto Porter,SF,26,CHI,14,9,331,62,140,0.443,24,62,0.387,38,78,0.487,0.529,19,27,0.704,13,35,48,25,15,6,11,31,167
Bobby Portis,C,24,NYK,66,5,1393,265,589,0.45,67,187,0.358,198,402,0.493,0.507,71,93,0.763,80,258,338,98,32,18,73,110,668
Kristaps Porziņģis,PF,24,DAL,51,51,1597,339,808,0.42,126,361,0.349,213,447,0.477,0.498,177,228,0.776,89,394,483,89,36,106,84,157,981
Dwight Powell,C,28,DAL,40,37,1061,146,229,0.638,10,39,0.256,136,190,0.716,0.659,74,111,0.667,75,152,227,59,34,22,36,102,376
Norman Powell,SG,26,TOR,44,23,1269,259,516,0.502,94,236,0.398,165,280,0.589,0.593,109,130,0.838,23,138,161,78,55,17,64,93,721
Chasson Randle,PG,26,GSW,3,0,40,0,4,0,0,2,0,0,2,0,0,5,6,0.833,0,2,2,5,2,0,0,3,5
Julius Randle,PF,25,NYK,64,64,2080,463,1006,0.46,64,231,0.277,399,775,0.515,0.492,258,352,0.733,151,471,622,198,51,22,193,178,1248
Josh Reaves,SG,22,DAL,2,0,1,0,1,0,0,0,,0,1,0,0,0,0,,0,0,0,0,0,0,0,0,0
Cam Reddish,SF,20,ATL,58,34,1551,213,554,0.384,83,250,0.332,130,304,0.428,0.459,101,126,0.802,35,181,216,87,62,28,96,132,610
J.J. Redick,SG,35,NOP,54,35,1425,251,558,0.45,156,345,0.452,95,213,0.446,0.59,147,163,0.902,9,131,140,108,19,9,65,86,805
Naz Reid,C,20,MIN,30,11,495,100,243,0.412,32,97,0.33,68,146,0.466,0.477,37,53,0.698,34,90,124,35,19,22,22,83,269
Josh Richardson,SG,26,PHI,48,46,1474,246,574,0.429,70,214,0.327,176,360,0.489,0.49,101,128,0.789,37,125,162,148,45,34,91,120,663
Austin Rivers,SG,27,HOU,60,4,1402,182,432,0.421,83,232,0.358,99,200,0.495,0.517,60,90,0.667,25,117,142,96,42,10,35,112,507
Duncan Robinson,SF,25,MIA,65,60,1949,286,613,0.467,243,543,0.448,43,70,0.614,0.665,48,53,0.906,9,203,212,91,35,15,60,179,863
Glenn Robinson III,SF,26,TOT,60,52,1743,281,578,0.486,74,191,0.387,207,387,0.535,0.55,72,83,0.867,78,182,260,96,53,16,53,97,708
Glenn Robinson III,SF,26,GSW,48,48,1516,244,507,0.481,68,170,0.4,176,337,0.522,0.548,63,74,0.851,66,160,226,85,45,14,50,82,619
Glenn Robinson III,SF,26,PHI,12,4,227,37,71,0.521,6,21,0.286,31,50,0.62,0.563,9,9,1,12,22,34,11,8,2,3,15,89
Jerome Robinson,SG,22,TOT,55,4,748,75,216,0.347,31,104,0.298,44,112,0.393,0.419,20,29,0.69,9,97,106,65,22,14,34,83,201
Jerome Robinson,SG,22,LAC,42,1,476,46,136,0.338,19,67,0.284,27,69,0.391,0.408,11,19,0.579,5,55,60,46,13,8,26,55,122
Jerome Robinson,SG,22,WAS,13,3,272,29,80,0.363,12,37,0.324,17,43,0.395,0.438,9,10,0.9,4,42,46,19,9,6,8,28,79
Justin Robinson,PG,22,WAS,9,0,49,5,12,0.417,3,5,0.6,2,7,0.286,0.542,0,0,,1,4,5,7,0,1,3,2,13
Mitchell Robinson,C,21,NYK,61,7,1412,253,341,0.742,0,0,,253,341,0.742,0.742,84,148,0.568,186,242,428,36,52,119,37,194,590
Isaiah Roby,SF,21,OKC,3,0,11,0,1,0,0,0,,0,1,0,0,0,0,,0,2,2,0,0,0,1,1,0
Rajon Rondo,PG,33,LAL,48,3,984,137,328,0.418,41,125,0.328,96,203,0.473,0.48,27,41,0.659,23,119,142,240,40,2,91,58,342
Derrick Rose,PG,31,DET,50,15,1298,369,753,0.49,45,147,0.306,324,606,0.535,0.52,121,139,0.871,27,94,121,278,40,16,126,49,904
Terrence Ross,SG,28,ORL,63,0,1723,316,777,0.407,162,454,0.357,154,323,0.477,0.511,136,161,0.845,13,190,203,74,69,22,62,95,930
Terry Rozier,PG,25,CHO,63,63,2164,398,941,0.423,172,423,0.407,226,518,0.436,0.514,166,190,0.874,50,226,276,259,61,10,141,126,1134
Ricky Rubio,PG,29,PHO,57,57,1802,252,611,0.412,66,188,0.351,186,423,0.44,0.466,174,204,0.853,42,223,265,507,88,9,155,143,744
D'Angelo Russell,PG,23,TOT,45,45,1452,360,846,0.426,158,431,0.367,202,415,0.487,0.519,161,199,0.809,17,160,177,285,48,13,147,86,1039
D'Angelo Russell,PG,23,GSW,33,33,1060,273,635,0.43,120,321,0.374,153,314,0.487,0.524,113,144,0.785,14,108,122,206,31,9,101,64,779
D'Angelo Russell,PG,23,MIN,12,12,392,87,211,0.412,38,110,0.345,49,101,0.485,0.502,48,55,0.873,3,52,55,79,17,4,46,22,260
Domantas Sabonis,C,23,IND,62,62,2159,458,848,0.54,17,67,0.254,441,781,0.565,0.55,214,296,0.723,189,582,771,310,47,30,170,195,1147
Luka Šamanić,PF,20,SAS,1,0,12,0,4,0,0,2,0,0,2,0,0,0,0,,0,2,2,3,0,0,0,0,0
JaKarr Sampson,SF,26,IND,26,10,340,48,81,0.593,2,13,0.154,46,68,0.676,0.605,11,20,0.55,15,44,59,9,9,9,7,43,109
Dario Šarić,PF,25,PHO,58,50,1441,217,470,0.462,73,214,0.341,144,256,0.563,0.539,79,95,0.832,89,256,345,109,34,15,72,132,586
Tomáš Satoranský,PG,28,CHI,65,64,1878,237,551,0.43,64,199,0.322,173,352,0.491,0.488,106,121,0.876,76,178,254,354,80,7,130,135,644
Admiral Schofield,SF,22,WAS,27,2,293,30,75,0.4,14,47,0.298,16,28,0.571,0.493,9,13,0.692,6,28,34,14,8,3,7,41,83
Dennis Schröder,PG,26,OKC,63,1,1952,442,945,0.468,122,320,0.381,320,625,0.512,0.532,193,230,0.839,19,214,233,256,43,14,159,138,1199
Mike Scott,PF,31,PHI,63,10,1119,130,319,0.408,73,204,0.358,57,115,0.496,0.522,25,30,0.833,58,167,225,48,19,5,24,85,358
Thabo Sefolosha,PF,35,HOU,41,0,436,37,91,0.407,15,54,0.278,22,37,0.595,0.489,3,8,0.375,21,72,93,25,24,12,15,43,92
Collin Sexton,SG,21,CLE,65,65,2143,513,1086,0.472,97,255,0.38,416,831,0.501,0.517,226,267,0.846,61,143,204,192,65,7,158,142,1349
Landry Shamet,SG,22,LAC,47,27,1294,146,351,0.416,105,268,0.392,41,83,0.494,0.566,57,63,0.905,6,84,90,87,19,9,36,130,454
Marial Shayok,SG,24,PHI,2,0,10,1,5,0.2,1,3,0.333,0,2,0,0.3,0,0,,0,3,3,1,0,0,1,0,3
Iman Shumpert,SG,29,BRK,13,0,241,21,64,0.328,8,33,0.242,13,31,0.419,0.391,4,7,0.571,9,25,34,12,12,2,10,21,54
Pascal Siakam,PF,25,TOR,53,53,1882,459,1000,0.459,115,320,0.359,344,680,0.506,0.517,220,275,0.8,57,342,399,191,53,49,132,151,1253
Chris Silva,PF,23,MIA,41,0,307,43,69,0.623,0,2,0,43,67,0.642,0.623,34,49,0.694,54,55,109,21,9,18,31,80,120
Ben Simmons,PG,23,PHI,54,54,1930,361,617,0.585,2,6,0.333,359,611,0.588,0.587,178,284,0.627,108,315,423,442,115,32,192,173,902
Anfernee Simons,SG,20,POR,65,4,1400,211,525,0.402,74,219,0.338,137,306,0.448,0.472,76,92,0.826,25,122,147,95,26,10,61,131,572
Alen Smailagić,PF,19,GSW,14,0,139,20,40,0.5,3,13,0.231,17,27,0.63,0.538,16,19,0.842,10,17,27,13,3,4,11,14,59
Marcus Smart,SG,25,BOS,53,39,1721,240,632,0.38,128,368,0.348,112,264,0.424,0.481,106,127,0.835,40,164,204,257,86,27,89,142,714
Dennis Smith Jr.,PG,22,NYK,34,3,537,72,211,0.341,16,54,0.296,56,157,0.357,0.379,27,53,0.509,21,57,78,98,28,8,58,65,187
Ish Smith,PG,31,WAS,60,19,1570,262,581,0.451,55,150,0.367,207,431,0.48,0.498,48,70,0.686,28,161,189,285,52,24,77,84,627
Zhaire Smith,SG,20,PHI,7,0,32,3,11,0.273,0,3,0,3,8,0.375,0.273,2,4,0.5,0,2,2,2,3,0,2,4,8
Tony Snell,SF,28,DET,59,57,1641,170,382,0.445,102,254,0.402,68,128,0.531,0.579,32,32,1,9,102,111,127,32,15,31,101,474
Omari Spellman,PF,22,GSW,49,3,886,127,295,0.431,43,110,0.391,84,185,0.454,0.503,73,92,0.793,77,142,219,47,33,24,54,63,370
Max Strus,SG,23,CHI,2,0,6,2,3,0.667,0,1,0,2,2,1,0.667,1,1,1,1,0,1,0,0,0,0,1,5
Edmond Sumner,PG,24,IND,25,2,345,47,111,0.423,10,38,0.263,37,73,0.507,0.468,10,15,0.667,10,27,37,39,15,8,19,35,114
Caleb Swanigan,PF,22,TOT,27,1,288,28,47,0.596,0,2,0,28,45,0.622,0.596,9,17,0.529,27,73,100,31,3,7,37,62,65
Caleb Swanigan,PF,22,SAC,7,0,23,2,4,0.5,0,0,,2,4,0.5,0.5,1,2,0.5,2,5,7,2,1,2,6,8,5
Caleb Swanigan,PF,22,POR,20,1,265,26,43,0.605,0,2,0,26,41,0.634,0.605,8,15,0.533,25,68,93,29,2,5,31,54,60
Jayson Tatum,PF,21,BOS,59,59,2043,499,1113,0.448,167,420,0.398,332,693,0.479,0.523,225,279,0.806,57,361,418,174,83,53,132,121,1390
Jeff Teague,PG,31,TOT,59,17,1464,213,489,0.436,43,117,0.368,170,372,0.457,0.48,172,197,0.873,27,115,142,308,44,19,116,106,641
Jeff Teague,PG,31,MIN,34,13,945,145,324,0.448,33,87,0.379,112,237,0.473,0.498,125,144,0.868,15,73,88,208,25,13,76,70,448
Jeff Teague,PG,31,ATL,25,4,519,68,165,0.412,10,30,0.333,58,135,0.43,0.442,47,53,0.887,12,42,54,100,19,6,40,36,193
Garrett Temple,SG,33,BRK,55,31,1547,198,524,0.378,112,346,0.324,86,178,0.483,0.485,56,73,0.767,28,162,190,141,44,26,57,95,564
Daniel Theis,C,27,BOS,58,57,1382,216,382,0.565,26,81,0.321,190,301,0.631,0.599,81,106,0.764,130,250,380,95,35,75,48,201,539
Isaiah Thomas,PG,30,WAS,40,37,925,174,426,0.408,78,189,0.413,96,237,0.405,0.5,62,76,0.816,11,57,68,146,13,6,77,77,488
Khyri Thomas,SG,23,DET,8,0,61,5,17,0.294,5,14,0.357,0,3,0,0.441,2,4,0.5,1,0,1,3,3,0,3,9,17
Matt Thomas,SG,25,TOR,33,0,321,54,111,0.486,35,75,0.467,19,36,0.528,0.644,7,10,0.7,7,41,48,17,8,0,12,31,150
Tristan Thompson,C,28,CLE,57,51,1721,288,562,0.512,9,23,0.391,279,539,0.518,0.52,99,161,0.615,226,351,577,120,33,50,103,124,684
Matisse Thybulle,SG,22,PHI,57,13,1110,96,234,0.41,50,142,0.352,46,92,0.5,0.517,25,41,0.61,35,51,86,70,80,40,45,120,267
Anthony Tolliver,PF,34,TOT,47,9,732,54,155,0.348,39,121,0.322,15,34,0.441,0.474,18,25,0.72,30,103,133,33,15,11,30,64,165
Anthony Tolliver,PF,34,POR,33,9,554,43,117,0.368,30,89,0.337,13,28,0.464,0.496,13,19,0.684,27,83,110,29,8,9,21,54,129
Anthony Tolliver,PF,34,SAC,9,0,82,3,17,0.176,2,15,0.133,1,2,0.5,0.235,1,2,0.5,2,9,11,3,4,1,4,6,9
Anthony Tolliver,PF,34,MEM,5,0,96,8,21,0.381,7,17,0.412,1,4,0.25,0.548,4,4,1,1,11,12,1,3,1,5,4,27
Juan Toscano-Anderson,SF,26,GSW,13,6,272,29,63,0.46,8,23,0.348,21,40,0.525,0.524,3,5,0.6,9,43,52,26,13,5,16,30,69
Karl-Anthony Towns,C,24,MIN,35,35,1187,316,622,0.508,114,277,0.412,202,345,0.586,0.6,180,226,0.796,95,283,378,153,33,42,110,117,926
Gary Trent Jr.,SG,21,POR,53,8,1059,149,350,0.426,78,201,0.388,71,149,0.477,0.537,30,36,0.833,20,68,88,50,39,13,19,69,406
Allonzo Trier,PG,24,NYK,24,1,291,51,106,0.481,19,53,0.358,32,53,0.604,0.571,34,43,0.791,6,23,29,28,3,4,22,29,155
P.J. Tucker,PF,34,HOU,64,64,2203,162,374,0.433,95,257,0.37,67,117,0.573,0.56,37,44,0.841,102,339,441,101,70,31,67,209,456
Rayjon Tucker,SG,22,UTA,14,0,78,8,19,0.421,0,6,0,8,13,0.615,0.421,3,5,0.6,2,11,13,2,1,0,3,7,19
Evan Turner,PG,31,ATL,19,0,251,25,67,0.373,0,5,0,25,62,0.403,0.373,12,14,0.857,8,30,38,38,9,8,26,20,62
Myles Turner,C,23,IND,55,55,1628,233,517,0.451,77,229,0.336,156,288,0.542,0.525,108,144,0.75,70,290,360,61,42,120,68,138,651
Jarrod Uthoff,SF,26,MEM,4,0,14,1,7,0.143,0,4,0,1,3,0.333,0.143,2,2,1,1,0,1,0,1,0,0,1,4
Jonas Valančiūnas,C,27,MEM,62,62,1630,385,657,0.586,29,79,0.367,356,578,0.616,0.608,123,168,0.732,190,506,696,109,25,69,107,159,922
Denzel Valentine,SF,26,CHI,36,5,488,97,237,0.409,46,137,0.336,51,100,0.51,0.506,6,8,0.75,9,65,74,43,26,6,26,51,246
Jarred Vanderbilt,SF-PF,20,TOT,11,0,46,5,8,0.625,0,1,0,5,7,0.714,0.625,2,2,1,3,6,9,2,3,1,7,6,12
Jarred Vanderbilt,SF,20,DEN,9,0,41,5,7,0.714,0,0,,5,7,0.714,0.714,0,0,,3,5,8,2,3,1,7,6,10
Jarred Vanderbilt,PF,20,MIN,2,0,5,0,1,0,0,1,0,0,0,,0,2,2,1,0,1,1,0,0,0,0,0,2
Fred VanVleet,PG,25,TOR,48,48,1719,287,701,0.409,131,338,0.388,156,363,0.43,0.503,140,166,0.843,18,162,180,317,91,13,110,118,845
Gabe Vincent,PG,23,MIA,6,0,42,4,19,0.211,4,16,0.25,0,3,0,0.316,0,0,,0,3,3,3,1,0,0,2,12
Noah Vonleh,C-PF,24,TOT,33,1,364,50,89,0.562,3,15,0.2,47,74,0.635,0.579,24,30,0.8,37,86,123,27,11,6,21,38,127
Noah Vonleh,C,24,MIN,29,1,347,47,86,0.547,2,14,0.143,45,72,0.625,0.558,23,28,0.821,34,82,116,26,11,6,19,36,119
Noah Vonleh,PF,24,DEN,4,0,17,3,3,1,1,1,1,2,2,1,1.167,1,2,0.5,3,4,7,1,0,0,2,2,8
Nikola Vučević,C,29,ORL,54,54,1763,428,910,0.47,82,249,0.329,346,661,0.523,0.515,114,146,0.781,130,466,596,202,46,47,77,121,1052
Dean Wade,PF,23,CLE,12,0,71,9,13,0.692,2,4,0.5,7,9,0.778,0.769,0,1,0,3,16,19,2,2,4,3,8,20
Moritz Wagner,C,22,WAS,37,5,707,131,228,0.575,23,67,0.343,108,161,0.671,0.625,67,82,0.817,51,141,192,49,22,17,55,134,352
Dion Waiters,SG,28,MIA,3,0,42,10,26,0.385,8,17,0.471,2,9,0.222,0.538,0,1,0,0,11,11,3,0,2,3,5,28
Kemba Walker,PG,29,BOS,50,50,1592,350,832,0.421,165,438,0.377,185,394,0.47,0.52,195,225,0.867,33,171,204,247,47,25,107,77,1060
Lonnie Walker,SG,21,SAS,53,4,767,116,267,0.434,29,71,0.408,87,196,0.444,0.489,38,53,0.717,20,95,115,46,28,13,31,70,299
Tyrone Wallace,SG,25,ATL,14,0,160,14,44,0.318,1,15,0.067,13,29,0.448,0.33,11,17,0.647,3,19,22,13,7,1,10,19,40
Taurean Prince,SF,25,BRK,64,61,1857,278,739,0.376,146,431,0.339,132,308,0.429,0.475,71,89,0.798,50,331,381,116,57,25,127,159,773
Derrick Walton,PG,24,TOT,26,1,248,18,39,0.462,10,24,0.417,8,15,0.533,0.59,7,9,0.778,2,14,16,27,7,0,5,21,53
Derrick Walton,PG,24,LAC,23,1,222,17,36,0.472,9,21,0.429,8,15,0.533,0.597,7,9,0.778,2,13,15,22,4,0,4,19,50
Derrick Walton,PG,24,DET,3,0,26,1,3,0.333,1,3,0.333,0,0,,0.5,0,0,,0,1,1,5,3,0,1,2,3
Brad Wanamaker,PG,30,BOS,63,1,1215,136,318,0.428,33,90,0.367,103,228,0.452,0.48,108,116,0.931,19,105,124,158,52,12,70,120,413
T.J. Warren,SF,26,IND,61,61,1984,460,869,0.529,69,184,0.375,391,685,0.571,0.569,151,186,0.812,61,181,242,87,70,27,77,170,1140
P.J. Washington,PF,21,CHO,58,57,1759,268,589,0.455,86,230,0.374,182,359,0.507,0.528,88,136,0.647,58,258,316,123,51,44,93,158,710
Yuta Watanabe,SG,25,MEM,16,0,99,12,29,0.414,3,8,0.375,9,21,0.429,0.466,3,8,0.375,6,11,17,4,5,1,2,9,30
Tremont Waters,PG,22,BOS,10,0,89,12,35,0.343,3,17,0.176,9,18,0.5,0.386,6,6,1,0,9,9,12,5,2,10,11,33
Paul Watson,SF-SG,25,TOT,5,0,25,0,8,0,0,4,0,0,4,0,0,1,2,0.5,0,4,4,5,1,1,0,1,1
Paul Watson,SG,25,ATL,2,0,17,0,7,0,0,3,0,0,4,0,0,0,0,,0,2,2,3,1,0,0,1,0
Paul Watson,SF,25,TOR,3,0,8,0,1,0,0,1,0,0,0,,0,1,2,0.5,0,2,2,2,0,1,0,0,1
Quinndary Weatherspoon,SG,23,SAS,3,0,15,0,3,0,0,1,0,0,2,0,0,0,0,,0,1,1,1,0,0,0,0,0
Russell Westbrook,PG,31,HOU,53,53,1905,568,1199,0.474,51,201,0.254,517,998,0.518,0.495,269,346,0.777,94,332,426,370,88,17,236,187,1456
Coby White,SG,19,CHI,65,1,1674,312,792,0.394,133,376,0.354,179,416,0.43,0.478,102,129,0.791,28,202,230,175,49,6,109,117,859
Derrick White,SG,25,SAS,61,13,1468,213,464,0.459,57,160,0.356,156,304,0.513,0.52,150,175,0.857,30,163,193,206,39,55,75,133,633
Hassan Whiteside,C,30,POR,61,61,1911,418,676,0.618,4,7,0.571,414,669,0.619,0.621,153,225,0.68,244,625,869,74,24,187,117,179,993
Andrew Wiggins,SF-SG,24,TOT,54,54,1858,437,978,0.447,111,334,0.332,326,644,0.506,0.504,190,268,0.709,66,208,274,198,45,53,132,127,1175
Andrew Wiggins,SF,24,MIN,42,42,1455,351,790,0.444,91,275,0.331,260,515,0.505,0.502,149,207,0.72,48,171,219,155,29,36,107,101,942
Andrew Wiggins,SG,24,GSW,12,12,403,86,188,0.457,20,59,0.339,66,129,0.512,0.511,41,61,0.672,18,37,55,43,16,17,25,26,233
Grant Williams,PF,21,BOS,62,5,970,80,192,0.417,21,85,0.247,59,107,0.551,0.471,37,51,0.725,58,107,165,62,28,33,46,149,218
Johnathan Williams,C,24,WAS,11,5,135,16,25,0.64,0,2,0,16,23,0.696,0.64,3,5,0.6,15,28,43,6,1,6,4,11,35
Kenrich Williams,PF,25,NOP,35,18,779,49,143,0.343,25,96,0.26,24,47,0.511,0.43,9,24,0.375,49,129,178,53,25,21,21,81,132
Lou Williams,SG,33,LAC,60,8,1757,367,883,0.416,107,295,0.363,260,588,0.442,0.476,278,322,0.863,28,158,186,344,40,10,172,77,1119
Marvin Williams,PF,33,TOT,52,1,1011,110,249,0.442,52,144,0.361,58,105,0.552,0.546,47,54,0.87,20,128,148,56,35,26,28,94,319
Marvin Williams,PF,33,CHO,41,1,808,94,210,0.448,44,117,0.376,50,93,0.538,0.552,43,50,0.86,15,94,109,41,26,22,25,71,275
Marvin Williams,PF,33,MIL,11,0,203,16,39,0.41,8,27,0.296,8,12,0.667,0.513,4,4,1,5,34,39,15,9,4,3,23,44
Robert Williams,C,22,BOS,23,1,323,42,62,0.677,0,0,,42,62,0.677,0.677,14,25,0.56,34,74,108,22,20,28,20,40,98
Nigel Williams-Goss,PG,25,UTA,9,0,28,1,7,0.143,0,2,0,1,5,0.2,0.143,2,2,1,2,3,5,5,1,1,2,2,4
Zion Williamson,PF,19,NOP,19,19,565,172,292,0.589,6,13,0.462,166,279,0.595,0.599,98,152,0.645,55,74,129,41,16,9,51,32,448
D.J. Wilson,PF,23,MIL,31,0,280,40,101,0.396,14,55,0.255,26,46,0.565,0.465,6,9,0.667,10,58,68,22,2,5,15,26,100
Justise Winslow,SF,23,MIA,11,5,352,50,129,0.388,6,27,0.222,44,102,0.431,0.411,18,27,0.667,16,57,73,44,7,5,24,38,124
Christian Wood,PF,24,DET,62,12,1325,288,508,0.567,54,140,0.386,234,368,0.636,0.62,180,242,0.744,104,286,390,60,34,54,84,98,810
Delon Wright,SG,27,DAL,65,5,1412,179,381,0.47,45,117,0.385,134,264,0.508,0.529,71,90,0.789,66,193,259,220,76,21,68,83,474
Justin Wright-Foreman,PG,22,UTA,1,0,2,0,0,,0,0,,0,0,,,0,0,,0,0,0,0,0,0,0,0,0
Thaddeus Young,PF,31,CHI,64,16,1591,269,601,0.448,79,222,0.356,190,379,0.501,0.513,42,72,0.583,94,221,315,117,92,23,102,134,659
Trae Young,PG,21,ATL,60,60,2120,546,1249,0.437,205,568,0.361,341,681,0.501,0.519,481,559,0.86,32,223,255,560,65,8,289,104,1778
Cody Zeller,C,27,CHO,58,39,1341,251,479,0.524,18,75,0.24,233,404,0.577,0.543,122,179,0.682,160,251,411,88,40,25,75,140,642
Ante Žižić,C,23,CLE,22,0,221,41,72,0.569,0,0,,41,72,0.569,0.569,14,19,0.737,18,48,66,6,7,5,10,27,96
Ivica Zubac,C,22,LAC,64,62,1156,202,336,0.601,0,2,0,202,334,0.605,0.601,107,141,0.759,166,295,461,69,13,60,53,146,511